wwwwwwwwwwwww
w.1w..w..13.w
w132w..1.1..w
w3...A..2..1w
w3w..w.1..3ww
w.3...w....ww
w........w..w
w3..+.13gw..w
wwwwwwwwwwwww
