wwwwwwwwwwwww
w.....w..2..w
w.212......1w
w32w1g.1.2..w
w.3.2.....22w
wA.........2w
w.2......2+.w
w.311.....33w
wwwwwwwwwwwww
