wwwwwwwwwwwww
w..12..231..w
w13.1123.23ww
w311+221..A3w
w1.2..1..w.3w
w..3w3..1.31w
w..13.g..3..w
ww..11w.21..w
wwwwwwwwwwwww
