wwwwwwwwwwwww
w3..2w.121w.w
w3.w..w23333w
w.3212g.w..1w
w3+.22321..2w
w3.33A.3w...w
w1...3.3.1.2w
w2.w.1.2..13w
wwwwwwwwwwwww
