wwwwwwwwwwwww
w.........2.w
w211..A22...w
w.3.1.......w
w........2.2w
w.2332.2g..2w
w.13.32....2w
w121.2.3.+..w
wwwwwwwwwwwww
