wwwwwwwwwwwww
www....w.+w3w
w2.....w...ww
ww..w..32..3w
w......1w...w
ww1.2Aw...gww
www.w.w..w..w
www.w.w.....w
wwwwwwwwwwwww
