wwwwwwwwwwwww
w.3w.w.323.ww
ww....w22.w2w
w...2..1w2w.w
w3ww1.2+.133w
w1w1w1.....ww
w.g2...ww...w
ww.wwwA3..w.w
wwwwwwwwwwwww
