wwwwwwwwwwwww
w.....w.....w
w.w.ww.3w.w.w
ww...2..wAwww
w...ww.+w..gw
w..w3w....w.w
w.........w.w
ww.3.w.www.ww
wwwwwwwwwwwww
