wwwwwwwwwwwww
w.w.3w......w
w...3w..2w2.w
wA...w...1..w
w33.333gw.1.w
w..w.+.121..w
w2.ww.2.3.2.w
w.w3.32w..1.w
wwwwwwwwwwwww
