wwwwwwwwwwwww
w...w33.1...w
w3.w.2..2.23w
w.+2A.21.213w
w1ww3w....w1w
w......w3.22w
w...g...1333w
w.....1.3...w
wwwwwwwwwwwww
