wwwwwwwwwwwww
w1.g1.w...w.w
w..12..33.w.w
w..w.ww.w..2w
w...12.wwww.w
w.w..A...+.ww
ww21w.2...11w
w12ww.w2..w3w
wwwwwwwwwwwww
