wwwwwwwwwwwww
ww13ww1..ww2w
w.3w1.233.+.w
www22.2w.3w.w
www...w.ww1.w
www21ww3.w13w
wwg3w3wA3.11w
w.w.1..3.w..w
wwwwwwwwwwwww
