wwwwwwwwwwwww
w..1.2......w
wA21.3.wg...w
w....11223..w
w...3.w21.2.w
w..113....31w
w..13......3w
w....13+....w
wwwwwwwwwwwww
