wwwwwwwwwwwww
w..3.33213..w
w.1..1.32...w
w.3w1..3..1.w
w.12.2.1A.13w
w..g..2.2..3w
w..23....231w
w1..2.1.+.3.w
wwwwwwwwwwwww
