wwwwwwwwwwwww
ww...w.2121ww
w3...w.3.g.ww
w..3.w.w...ww
w..w..+w1..ww
w2..1w3ww.1.w
w1ww.ww..w.ww
w.w...ww..Aww
wwwwwwwwwwwww
