wwwwwwwwwwwww
w..wwww.....w
w...w....3.ww
w..2www....+w
w...w.....2.w
w..ww1.....gw
w.w.........w
w.....w.A..ww
wwwwwwwwwwwww
