wwwwwwwwwwwww
w...w...w...w
w2.+...1.2w.w
w...1...23..w
w...g3A.....w
w......w.2..w
w.w.......3.w
w...........w
wwwwwwwwwwwww
