wwwwwwwwwwwww
w3ww..w31.+.w
w..www.w.21Aw
www.www.www2w
w.ww.w.w.3w1w
w.3ww.w.wwg3w
w.wwww.1..www
w..23.w3w13.w
wwwwwwwwwwwww
