wwwwwwwwwwwww
w.ww..11w2w.w
w.w....ww...w
w...1..2...ww
w.A2.2.2.322w
ww...1....+ww
w.12..3w.3.1w
wg3..12w....w
wwwwwwwwwwwww
