wwwwwwwwwwwww
w.3gww...w..w
w.w2w..+...ww
w.3www......w
w.wA.....w..w
w3....1...w1w
w...3w.w.32ww
www......3www
wwwwwwwwwwwww
