wwwwwwwwwwwww
www...21.2.3w
w.+.32....23w
w.A1w..2....w
w32111.w.1www
w.g.w2...3.1w
w12..w..332ww
w.13.2312132w
wwwwwwwwwwwww
