wwwwwwwwwwwww
w1+32w1..ww2w
w.1.3.12..w.w
www1w.32.2w.w
w3w...ww.22.w
www.3231.w11w
w3g213.Aw.12w
www.w.w1ww.ww
wwwwwwwwwwwww
