wwwwwwwwwwwww
w13..+.w121.w
w..w3w..3..ww
wwA..ww..3..w
w..3.w1ww..ww
ww..w...w.w.w
w.3....1g.w.w
w.3w.2w.3...w
wwwwwwwwwwwww
