wwwwwwwwwwwww
w.2..2.3...2w
ww1..2..111.w
wA3.w1.2.3.1w
w.......3313w
w....+.w3g..w
w........3.1w
w...w..3..w.w
wwwwwwwwwwwww
