wwwwwwwwwwwww
ww.2..w3w..1w
w...w1.32ww.w
w....2....www
ww..A.3.1...w
w..w.w....w3w
w..w....g.w.w
w..+33w....ww
wwwwwwwwwwwww
