wwwwwwwwwwwww
w...........w
w......g....w
ww..........w
w......1...ww
w...w.w...3.w
ww..3.w.....w
wA1...w.+...w
wwwwwwwwwwwww
