wwwwwwwwwwwww
w.www.ww.ww.w
ww..w.w.....w
ww.w.ww....ww
w..wA.32.w..w
ww....ww3.w3w
w.www...www.w
ww32g.+w.w..w
wwwwwwwwwwwww
