wwwwwwwwwwwww
w.w..gww.w.ww
ww..w..2+wwww
w.....ww...ww
w.w.www...Aww
w3www2ww3.w.w
w...ww..ww3.w
w.2.3w.w...ww
wwwwwwwwwwwww
