wwwwwwwwwwwww
w..3..22...2w
w1.+..1332..w
w2..3..g....w
w...22.3..3.w
w.3.........w
w1...A3.1.2.w
w..1...1.3..w
wwwwwwwwwwwww
