wwwwwwwwwwwww
w3.w.3.....gw
w....1....w.w
w........1..w
w.3...w.....w
w.w........+w
w.....2.w..Aw
ww....12w...w
wwwwwwwwwwwww
