wwwwwwwwwwwww
w21..+.w232ww
w21.23...ww.w
wg3.1w23w...w
w12..3www.www
w..113w..ww3w
wA132w.1.1w.w
w..3.w2www..w
wwwwwwwwwwwww
