wwwwwwwwwwwww
w1...2...13.w
w..1.1...g.2w
w.....11w123w
w+.2A.3.2232w
w..w.3....1.w
w..23.1.1...w
w...22......w
wwwwwwwwwwwww
