wwwwwwwwwwwww
w313211.2..1w
w.1w1..1w.w1w
w.33w.1w.+..w
w2....1.w13.w
w.3g2111w322w
w132331A2.31w
w...w.w2....w
wwwwwwwwwwwww
