wwwwwwwwwwwww
w.w.w3g...w.w
ww.w.1.w3..2w
w11.2..1..w1w
wwA..w....1.w
w.1.w.w1.3.3w
w.3.w...2w3+w
ww2.1w.3....w
wwwwwwwwwwwww
