wwwwwwwwwwwww
w...w..3.w1ww
w..2......1ww
w.2....311w.w
w..2w...3.w.w
w.ww.3w.2w..w
w....2w.g11+w
ww....23...Aw
wwwwwwwwwwwww
