wwwwwwwwwwwww
w..w.1ww312ww
w.1...w.w.w.w
ww...Aw1.g..w
ww...w.wwww3w
w.....w.+w23w
w.3....w.32.w
w1..w.1...w.w
wwwwwwwwwwwww
