wwwwwwwwwwwww
w33..233.1.3w
w12111232...w
w3...11.23..w
w211.2ww.3A.w
w3g.32132.1+w
w1.3....2...w
w1.1121222www
wwwwwwwwwwwww
