wwwwwwwwwwwww
w1..1g.w..21w
w..1..w....3w
w2....1.....w
w+..wA....www
w......w.w..w
w......2..w.w
w.w........ww
wwwwwwwwwwwww
