wwwwwwwwwwwww
w.........w.w
www....3....w
w...+...w313w
w.3gw3....2.w
w.....w..w.1w
ww..1..2213Aw
w..2.1...w1ww
wwwwwwwwwwwww
