wwwwwwwwwwwww
w3.....22.w.w
w3+...1....ww
w.3..3w.....w
w.....3...3.w
w..2....w...w
w...w......gw
w.Aw..w...12w
wwwwwwwwwwwww
