wwwwwwwwwwwww
w...1.1.3.3.w
w3.2...2.3.1w
w3.w3.11..23w
w2.3.g.2....w
w.1....21.3.w
w....A......w
w..+2.......w
wwwwwwwwwwwww
