wwwwwwwwwwwww
w1.3.....2..w
w3.....22...w
w1....1..2..w
w.Aw...w...1w
w..3..g...3.w
w2....+w..2.w
w2.3...2...2w
wwwwwwwwwwwww
