wwwwwwwwwwwww
w1.w....w.gww
w.....213.3.w
w.w13.3..w..w
w3.3w..w.1.2w
w.+...2w.1.ww
w...3.2.2..2w
w22...Aw.2.3w
wwwwwwwwwwwww
