wwwwwwwwwwwww
w13.31...121w
w331.3213321w
w..3...1..A3w
w3.3...1.3..w
w2.13133..11w
w1..12+.1g1.w
w.2212.w1..2w
wwwwwwwwwwwww
