wwwwwwwwwwwww
w.+w.21..w22w
w3.gw....w.2w
ww2.3.2...3.w
w32.2.2..2.2w
w2.......1.3w
w2...2...A.1w
w........2.3w
wwwwwwwwwwwww
