wwwwwwwwwwwww
w21+1w.w.wg1w
w..ww.w22...w
w.3.1.....A.w
w....3..3...w
w.w.....w.2ww
w..2.w....3.w
w13w..2.w..ww
wwwwwwwwwwwww
