wwwwwwwwwwwww
w.3.1..2....w
w..w.2...11ww
ww.2.3...1.3w
w.2..1....1Aw
w.1+.......ww
w3.w...1..3ww
w....2.g1...w
wwwwwwwwwwwww
