wwwwwwwwwwwww
ww1...1..21.w
w....w221.1.w
w.22...2..3ww
w........w..w
wg3www3.w...w
w.1..A.2w22ww
w...2.3.w2.+w
wwwwwwwwwwwww
