wwwwwwwwwwwww
w.111.w1.32.w
w21.2w..1g3.w
w.31.12..13.w
w12.232..222w
w2..32.Aw2.3w
w32..12..w3.w
w....1+31.31w
wwwwwwwwwwwww
