wwwwwwwwwwwww
w...........w
ww...A+....gw
w.........www
w...3..3w...w
w.1........3w
w23.3..1....w
ww......3..2w
wwwwwwwwwwwww
