wwwwwwwwwwwww
w..2w..12wwww
wwww2.3...11w
w1w31gww.3.Aw
w.2w1+2w.33ww
w.3.3.2ww.1.w
w.23.1w..ww.w
w.ww.21.w1www
wwwwwwwwwwwww
