wwwwwwwwwwwww
w.3...3.A..2w
w2.3.321..2.w
w3g...3.....w
w.2..1...1.2w
w13....12...w
w....131....w
w...3.3.1..+w
wwwwwwwwwwwww
