wwwwwwwwwwwww
ww..........w
w....A......w
w.w..+..ww..w
w.w.........w
w...........w
w..g...w....w
w...........w
wwwwwwwwwwwww
