wwwwwwwwwwwww
w..1......2.w
w..1..2.22..w
w.......2.3.w
w1...3.A....w
w...........w
w2.32.2g....w
w21..+......w
wwwwwwwwwwwww
