wwwwwwwwwwwww
w.w1w...1.3.w
ww.w......w.w
w...2.ww.w..w
www32.ww...Aw
w......w.1..w
w1..w...ww2.w
wg..11+..1www
wwwwwwwwwwwww
