wwwwwwwwwwwww
w+.w1.223232w
w..123g..21.w
w....31..323w
w..2.3..2321w
w....13...23w
w311w3A.3...w
w23.2w3132.2w
wwwwwwwwwwwww
