wwwwwwwwwwwww
w2.1.222....w
w.3........1w
w.31....3..+w
w3g.22..1.1.w
w3.2.1......w
w.A...31....w
w.3...31.2..w
wwwwwwwwwwwww
