wwwwwwwwwwwww
w.......3...w
w+.3wA.w31w.w
w.2ww..w..3.w
ww..g33.2..ww
w.3.....w222w
ww1.12w..w.3w
w22ww.1...w.w
wwwwwwwwwwwww
