wwwwwwwwwwwww
w.w..www...ww
w.w....w..w.w
w.w1....w...w
www....wA.w+w
w.....w....ww
wwww.....g.ww
w..w....w...w
wwwwwwwwwwwww
