wwwwwwwwwwwww
wA.+...2.2w.w
w.23.33.2122w
w11.w..22g2.w
w.112213..23w
w1112w....3ww
ww12.31.2...w
w12312.w.321w
wwwwwwwwwwwww
