wwwwwwwwwwwww
w3A.w.3..w..w
w11.w.+.....w
w......w3...w
w....g...1..w
w3..w.w.w...w
ww....3.22w.w
ww....w.3...w
wwwwwwwwwwwww
