wwwwwwwwwwwww
w.w...3.w.www
w.........w.w
w3..w.A.....w
wg.1......2.w
w...1+......w
w.........1.w
w..w......2.w
wwwwwwwwwwwww
