wwwwwwwwwwwww
w32.2.w2.2.ww
w.www..w..2.w
w1....3.1w..w
w..3..22.31.w
w2A.2ww33..ww
ww......w2..w
ww..+gww.w3.w
wwwwwwwwwwwww
