wwwwwwwwwwwww
ww..3..1.3www
w.w.....2...w
w1...12....2w
w2..w.33..w.w
w.w..2...A..w
w...332..2..w
w..+12..w.g.w
wwwwwwwwwwwww
