wwwwwwwwwwwww
w..3......2.w
w2..3.331w..w
w1..2.32.111w
w.31.A.w1...w
w...g+..2...w
w.......113ww
w...1.1..w..w
wwwwwwwwwwwww
