wwwwwwwwwwwww
ww.g...A....w
w.1w2w312...w
w.....1.1.1.w
ww.2+ww.w.1.w
w32..1......w
w2.w.....w.2w
ww.12...w...w
wwwwwwwwwwwww
