wwwwwwwwwwwww
w21.13...1Aww
w13.....w1+.w
w1w.1..23w..w
w2.13.2..1.ww
w.w..3w...11w
w11.3..1.3.ww
w1..2..g..12w
wwwwwwwwwwwww
