wwwwwwwwwwwww
w.1.w1..3...w
w.A..w.g..w.w
w....3w3.w1.w
w2w1w.......w
w.ww...w...1w
w.w.3ww...w.w
w..1w.+.w..ww
wwwwwwwwwwwww
