wwwwwwwwwwwww
w.3.3..1w.2+w
ww..w.1.1w3.w
w..22..3ww.3w
w.....3.121.w
wwww1.1.1..1w
www.w.3w..A.w
w.2wg1w33331w
wwwwwwwwwwwww
