wwwwwwwwwwwww
w1www33A..12w
w.12w.ww...ww
ww.3.1wgw.w.w
w3..w.2.31.ww
w.w13.ww32.2w
w.w3.w.w1.w+w
w...w2.w.w.ww
wwwwwwwwwwwww
