wwwwwwwwwwwww
w1..1.www3.3w
www1wwww.ww.w
w11www.w..w.w
w.2..ww.w...w
wA..wwww....w
wg......+.3ww
w3......ww.2w
wwwwwwwwwwwww
