wwwwwwwwwwwww
w.312132..2.w
w.......33..w
w.22..1g2..3w
w311.2..2.w.w
w1.3A2.3....w
w3.3.32.33w3w
w32w.2.+.11.w
wwwwwwwwwwwww
