wwwwwwwwwwwww
wg2w2www12www
ww..1.3w...3w
w.3w.33w..w.w
w23w.3..213.w
w.12.32w.22.w
w.ww..A13w3.w
w3+11.w1....w
wwwwwwwwwwwww
