wwwwwwwwwwwww
ww.w.w.....1w
ww3...3w.w3.w
w.w32.w.ww.ww
ww.w.wwww2..w
w....33.21www
ww..ww+.1w.ww
w.g.w.A...www
wwwwwwwwwwwww
