wwwwwwwwwwwww
w.w2A+ww.wwww
ww.wg.www2..w
w.w.......w.w
wwww.ww.3w..w
ww..ww3w.ww1w
www....w.w..w
ww2w.2w.....w
wwwwwwwwwwwww
