wwwwwwwwwwwww
w.1..w.wg.w1w
w...www.....w
www.www2.Aw3w
w.ww.www...+w
w...www...www
w.2..ww...www
w....w..w.w3w
wwwwwwwwwwwww
