wwwwwwwwwwwww
w333..w..2.2w
ww.2..3+w...w
w......3..31w
w1..1.......w
w...3...1A..w
w2..g1......w
w...3.w.....w
wwwwwwwwwwwww
