wwwwwwwwwwwww
w31....+11.1w
w2122...ww.1w
w21.w33w2w..w
ww3..12.ww1ww
ww.wA.323...w
w.g332ww.w.ww
w3..w31.ww..w
wwwwwwwwwwwww
