wwwwwwwwwwwww
w.1.1w.32.33w
w3+13w......w
ww.w3.2.3w2Aw
w.g.2ww..321w
www3w1.32w2.w
www1.11w.w.1w
w..w.333w.1.w
wwwwwwwwwwwww
