wwwwwwwwwwwww
w3..wg.1+3.ww
w3.3.231.1w.w
w.3.2w......w
w3w..22..21.w
w.w..www.w..w
w...Aw2.w..ww
w..3.w.3.1.1w
wwwwwwwwwwwww
