wwwwwwwwwwwww
w.2..w2.2.22w
w..133w3.3w1w
w3.2w3w..32ww
ww.g212+13A3w
w.ww13.1w3w.w
w.w1.2.w1w..w
ww3ww......2w
wwwwwwwwwwwww
