wwwwwwwwwwwww
ww...ww2.w.ww
w.1....2A...w
w.2....www..w
ww.www.w1.w.w
w.w.1.3.....w
w2.ww.w..gw.w
wwww.+....w.w
wwwwwwwwwwwww
