wwwwwwwwwwwww
w11.w..w322.w
w.A.+.3....ww
wwwwg.w211w3w
ww....w..1w3w
w..3.w3..w..w
www..1..1.31w
ww1....w1.33w
wwwwwwwwwwwww
