wwwwwwwwwwwww
w...+w....w.w
wA1.w...1w..w
w.w.w.1www2ww
www..w3g...1w
w......ww.3.w
www.w..ww11.w
ww..........w
wwwwwwwwwwwww
