wwwwwwwwwwwww
w.....ww..w.w
ww.....1w.w.w
w..+123.....w
w..w.w.3.g..w
w.w..w1.w23Aw
w2.w..w.ww.ww
w..ww......ww
wwwwwwwwwwwww
