wwwwwwwwwwwww
w1g..23.3..3w
ww1.21w.....w
w..1..www...w
w.w1.332.A.2w
w1w.ww...2www
w+.1..2.w...w
w.....1...1.w
wwwwwwwwwwwww
