wwwwwwwwwwwww
w+...w....w.w
w.g...2311..w
w.A.........w
w.2.........w
w12..11.....w
w.w1....w...w
w.ww31....1.w
wwwwwwwwwwwww
