wwwwwwwwwwwww
w..3..12..2.w
w...A.w1...1w
w.....3.....w
w+.2....13..w
w..3...2.g..w
w.w..w....1.w
w.2..32...1.w
wwwwwwwwwwwww
