wwwwwwwwwwwww
wA..+...3.21w
www.w...1...w
w......1ww1.w
ww.w.w.ww.www
www.1..g....w
w.3wwwwww...w
w..3.2..ww..w
wwwwwwwwwwwww
