wwwwwwwwwwwww
w2.2ww.1w.w1w
w.w....w..www
www3w3+....Aw
www3.3...2www
w.g..2www..ww
w13.3.ww.w3ww
w1ww.w..ww.ww
wwwwwwwwwwwww
