wwwwwwwwwwwww
w.w.........w
wA.2..w3....w
w.w.........w
w........w..w
w........w..w
w..+.w......w
ww2...g...1.w
wwwwwwwwwwwww
