wwwwwwwwwwwww
w..w...w.w1.w
w3...w.21.2.w
w1w3.+.w1..2w
w.3...w1..3.w
wwA.g111w1..w
ww....2..2..w
w.1....w.w.ww
wwwwwwwwwwwww
