wwwwwwwwwwwww
www..g3..+..w
w.w3.22w..w.w
w..w312w.w.2w
w...13.w..A.w
w3w1..131...w
w2.12.....www
w..w3.1..w..w
wwwwwwwwwwwww
