wwwwwwwwwwwww
ww22w3332w..w
wwww2www2..ww
ww.2w.21www.w
www..www2gw3w
ww3w2ww.2w.ww
ww.wA....w+ww
wwww.www...1w
wwwwwwwwwwwww
