wwwwwwwwwwwww
wA13111.23.3w
w.1..2..1..3w
w2..w1.+.212w
w23.3.1...2.w
w1313.131...w
w.2.ww.3.1w.w
w.w...2g.w..w
wwwwwwwwwwwww
