wwwwwwwwwwwww
w..w2322A3..w
w...2+ww.3.1w
w3wwww2.w..1w
w.ww.3113.2ww
w12w2w2..3.ww
ww1.331.221gw
ww.1..22.1www
wwwwwwwwwwwww
