wwwwwwwwwwwww
w.w..w.www.ww
ww.www..ww..w
w.w...wwwwwww
w..wwww.w.w.w
w.wwg...ww.ww
w.w.ww+.w...w
w..1w.w.A.www
wwwwwwwwwwwww
