wwwwwwwwwwwww
w..www..13.ww
w.w.ww..+w32w
www..3ww.2g.w
ww...2.3.23.w
w3.www1w1w1ww
wA.31.ww13w1w
w3w.2.w.2w3.w
wwwwwwwwwwwww
