wwwwwwwwwwwww
w....w......w
w...........w
wg..........w
w.1....+....w
w.....w.....w
w...3.......w
w..A...w..w.w
wwwwwwwwwwwww
