wwwwwwwwwwwww
w121+23w1w2.w
w2w.....1.31w
w.w.1w3...w1w
ww2...31.2.Aw
w.3.3.1.1223w
w2.2.1.3..g.w
w.3131122..2w
wwwwwwwwwwwww
