wwwwwwwwwwwww
ww22www.+.wAw
ww.31.www323w
ww1..www1ww.w
ww22.....w31w
w.2.w...w1w2w
ww2www1www2.w
w.g3ww33.2..w
wwwwwwwwwwwww
