wwwwwwwwwwwww
w22...13w..1w
w2.w.w.22w.1w
w.ww1..www+.w
www..w1....ww
w..w.w21...ww
w.3..w...Aw.w
w.gww...1w.3w
wwwwwwwwwwwww
