wwwwwwwwwwwww
ww..g...w...w
wwww.+wwww3.w
ww.....ww...w
w..w..A....ww
w....33w2.w.w
w...3.ww....w
www2.w.w..1ww
wwwwwwwwwwwww
