wwwwwwwwwwwww
w.1.w.33...ww
w..wA.3...w3w
ww1w21..2.2.w
w2..w..ww..ww
ww.w.w3ww2w2w
w.w.w.www+wgw
www1w....2..w
wwwwwwwwwwwww
