wwwwwwwwwwwww
w3..2w.2wwwww
w.223w22212.w
www.1w331gw3w
w12w3.ww..www
w....ww3..w.w
w.A...w..w.1w
w233w+.1ww..w
wwwwwwwwwwwww
