wwwwwwwwwwwww
w.32.31..3..w
w....11g.2..w
w.3..+...111w
w.......2...w
w....w.....1w
w...2...A..3w
w1..2.22....w
wwwwwwwwwwwww
