wwwwwwwwwwwww
www1.3wwwww.w
w.23..www1.2w
w.3ww23.wg.3w
ww.2ww.3.w3Aw
wwwwww1ww.3.w
w.ww1..w1..ww
w.www.33ww3+w
wwwwwwwwwwwww
