wwwwwwwwwwwww
w...3..2.+..w
w...12.....1w
ww...2w.2w.2w
w31.111133.3w
w2..3....w.3w
w..w.g.3..A.w
w1.2w....31.w
wwwwwwwwwwwww
