wwwwwwwwwwwww
w......2.3..w
wwww...wAw31w
w2.ww..w23www
w......ww.w.w
w..w....w..2w
wg...w..+.w.w
w1....2w.ww1w
wwwwwwwwwwwww
