wwwwwwwwwwwww
w.1.ww3..A.ww
w.w....+3..2w
w.13....1..3w
w.1.2..w.2.ww
w32ww.3....2w
w.w...1...w.w
w.ww..w..g2.w
wwwwwwwwwwwww
