wwwwwwwwwwwww
wwww...33..ww
w3w.3w1.g1..w
w2.3.33..2.3w
w...w.......w
w...2...2.Aww
ww1.+.w32.31w
w.ww..w2...ww
wwwwwwwwwwwww
