wwwwwwwwwwwww
w...1.....+.w
w...3..2....w
w.g323.3....w
w.3w....1...w
w...3..1..A.w
w2.2....11..w
w.....1..3.2w
wwwwwwwwwwwww
