wwwwwwwwwwwww
ww..w.3..2w.w
w..w.w....3.w
w.w..w...3w3w
w.w.....3...w
w.w3+..322..w
w1g.11w12...w
w.A.ww..w3w.w
wwwwwwwwwwwww
