wwwwwwwwwwwww
ww3w1g...22.w
w1ww2w.w...2w
w.33.23w.2.2w
wA2..w2.2.1.w
w1.1.1.w+12ww
w233.113.w.2w
ww2.w1w3ww.ww
wwwwwwwwwwwww
