wwwwwwwwwwwww
wwA..ww23131w
w..w.w..12www
w3133w..3w23w
w1w1gww.1..ww
ww.w....w...w
ww.2...1w.+.w
www2.3.2132ww
wwwwwwwwwwwww
