wwwwwwwwwwwww
w.21...3..13w
w1.213+..132w
w..g2A..3...w
w32...w1.w..w
ww3w23....3.w
w32.2.3w2.2.w
w..1.ww133..w
wwwwwwwwwwwww
