wwwwwwwwwwwww
www.A.www.w.w
w.3.w.w3w331w
www1..w.1w.ww
w...22323..1w
w23w1.13gw..w
w.3w1ww2....w
w.w.31...+1ww
wwwwwwwwwwwww
