wwwwwwwwwwwww
w...1w.A123gw
w+.ww.1.w.www
w.22w1....2.w
w.2w.31..2..w
w11w.313ww2.w
w23.....313ww
w3.w...2w..ww
wwwwwwwwwwwww
