wwwwwwwwwwwww
w.+...w21.g1w
w...322.2...w
w.2...3.ww..w
w..2.2w...3ww
w3......13.3w
w.www..3...1w
w.23..2A..1ww
wwwwwwwwwwwww
