wwwwwwwwwwwww
w3g.3...3..2w
w1.......w31w
ww32..2..11.w
www2.3.2w.33w
w..w..32ww3.w
w1w..w......w
w..3w2A.+..3w
wwwwwwwwwwwww
