wwwwwwwwwwwww
w+g33..12wA2w
w.2..1.2w...w
w.11.3w..w..w
w.ww2w.3..13w
w.w..1w.2w23w
w...w..21.1.w
w33.133..2w3w
wwwwwwwwwwwww
