wwwwwwwwwwwww
w..2.w.w..w.w
w..w1ww2....w
w......3.231w
w3..+..1.32ww
w...A2.w....w
w..3..2..2..w
w.3w33.w..g3w
wwwwwwwwwwwww
