wwwwwwwwwwwww
w.www.2w2ww1w
w.w3w.2wwww.w
ww...23w.ww.w
w3w.w.31.ww.w
wwww31g32221w
w2www.A+.w.ww
ww.ww2.31w31w
wwwwwwwwwwwww
