wwwwwwwwwwwww
w.1ww.1...w2w
ww121w1.3.22w
w1...2.2.321w
w+w32.22..g.w
w21.w2wwww.3w
w..2.w..ww.2w
wwwwA.31.2w1w
wwwwwwwwwwwww
