wwwwwwwwwwwww
w.2ww.2A2...w
w..23......2w
w.w2........w
w.+2.....21gw
w..w.3....w.w
w..1.3..2..2w
w......2....w
wwwwwwwwwwwww
