wwwwwwwwwwwww
w.2ww2.1.32.w
w.g2.ww.3.w3w
w.22www11..+w
wA2....w..w.w
w3.3..2.2ww2w
w....3ww..2.w
ww3.w...1w.3w
wwwwwwwwwwwww
