wwwwwwwwwwwww
w3.1ww2w23..w
w..w21...ww2w
w.w1....1..ww
w22..11w3g.2w
www3A121ww11w
ww21ww.w22.2w
w21w.1.31+13w
wwwwwwwwwwwww
