wwwwwwwwwwwww
wwA3.332.3..w
w1w22....1.3w
w....w.2...1w
w...w..w1..2w
w31w.+.1..wgw
w.......w..3w
w2..3..1....w
wwwwwwwwwwwww
