wwwwwwwwwwwww
ww.wA11.w221w
wwwwww.ww2.2w
w.+1.w.2...ww
w.1231w23..1w
w.1.w.g3w3..w
www1www.w32.w
w12323w31..3w
wwwwwwwwwwwww
