wwwwwwwwwwwww
w.33.1www22.w
w3A11...122.w
w23w2111.ww.w
w2.....w.gw3w
w2...2...w+.w
w13...2.3.3.w
w11..2w.w..ww
wwwwwwwwwwwww
