wwwwwwwwwwwww
w..1..+.123ww
ww...w.w1.1.w
w..211ww2.1.w
ww1w..ww21.Aw
w...wgw3..31w
ww3.12223..1w
w3ww.2.w2ww2w
wwwwwwwwwwwww
