wwwwwwwwwwwww
w.321w3ww.1.w
w..3..11.w.2w
wwgw2ww1.ww2w
ww23.w.w.+w3w
w..23w..ww.ww
w21.w.2A.ww2w
w.21..2.2.w2w
wwwwwwwwwwwww
