wwwwwwwwwwwww
w32.w...w2..w
w.w..g..1...w
wwww212ww1..w
w+23w31.w1w.w
ww3.w1..A.2ww
ww..1w.w.2..w
ww......w...w
wwwwwwwwwwwww
