wwwwwwwwwwwww
w.w...1...www
w13.3.w3.w.3w
wA.3ww1w.3.ww
w.2.3231w.www
w..wwwgw1.w3w
w..w.w..w+..w
w13.2.1.w.3ww
wwwwwwwwwwwww
