wwwwwwwwwwwww
w.w.w.w2w13ww
w..ww..1....w
ww2gw.w....ww
w.w.23.1...ww
wA1.........w
w..12...3.w.w
w.w.w+2..w21w
wwwwwwwwwwwww
