wwwwwwwwwwwww
w.3A22.1....w
w...1112....w
w1...+..3...w
w.3g1.1....ww
w2.31.31w.3.w
ww11....w1w.w
w.122..w2w..w
wwwwwwwwwwwww
