wwwwwwwwwwwww
w32ww.3231www
w.w.3..w.ww.w
w.1.323.....w
w2wwwwww1.22w
w3w1.ww321+.w
w....w111w.ww
wgw.w...A.w.w
wwwwwwwwwwwww
