wwwwwwwwwwwww
w3132.w3w.33w
www.2.1.w..ww
w1...1.....3w
wwAgww....3ww
w1233w3ww..ww
w.2.1w.2.211w
w+w.1w.ww3..w
wwwwwwwwwwwww
