wwwwwwwwwwwww
w211....32w.w
w....2.w....w
w113w...w2..w
w.23w.2w.3A.w
w.w..w.1+..2w
w....wgww.w.w
w1..33..3w1ww
wwwwwwwwwwwww
