wwwwwwwwwwwww
w.32w..31313w
w21w1.33w.2.w
w..w13ww3.+Aw
wg11.w.31w11w
w2w..3w3w1.2w
w.3..31....ww
w.133.w3w112w
wwwwwwwwwwwww
