wwwwwwwwwwwww
w...1.......w
w.....ww1...w
w...323.12w2w
w.........w2w
w..w.21A.2..w
w...gwww..1ww
w3.+3w3.....w
wwwwwwwwwwwww
