wwwwwwwwwwwww
w111w..w31..w
w.3...www...w
w.2w.1....+ww
w3..31gw...ww
www.2.....w.w
w.2w.w.1.22.w
www2wA.31..2w
wwwwwwwwwwwww
