wwwwwwwwwwwww
w.w12A12.2..w
w.w....ww.w.w
w+21w.13..w1w
w1....3..w2.w
w.w...1wg.21w
w2.21.w..1.ww
w.13w3..21w.w
wwwwwwwwwwwww
