wwwwwwwwwwwww
w.+w....w.w.w
wA1ww.w.3g..w
ww....w.w.w.w
w...w3..w...w
w.....3.3.31w
w.....133.23w
w23.3w.w.3.ww
wwwwwwwwwwwww
