wwwwwwwwwwwww
w1.11....A.2w
ww22..2..2..w
ww3w...2.w2.w
w.2...1.w..ww
w1....32..w.w
wg+1w1..w...w
ww..2..w.2..w
wwwwwwwwwwwww
