wwwwwwwwwwwww
w12ww.1...www
w3.wAgwww.w.w
ww.1....1.w1w
w..w.3.3.3..w
w2.w3..2...ww
w..+3..w.w..w
ww..11ww....w
wwwwwwwwwwwww
