wwwwwwwwwwwww
ww3.32+..ww.w
w121...321..w
wwg1.1w.11w.w
ww1...w.1..3w
ww..32w...w1w
w.www....ww2w
w.2w.3..Aw12w
wwwwwwwwwwwww
