wwwwwwwwwwwww
w31w..w2.w+.w
w3.2w..3..3ww
w11.2.A1.1w.w
wwww.1232.21w
w232w12.2113w
w232w.2g..w.w
w2..w21122..w
wwwwwwwwwwwww
