wwwwwwwwwwwww
w.32.w1.3w.1w
w.1wwww...w.w
w..32.222...w
w..w.w12w322w
w3w3.11+A1.ww
wwwww...2w.3w
w.g..32w..3.w
wwwwwwwwwwwww
