wwwwwwwwwwwww
w.22.w131.23w
w.A...3.....w
ww...1.1.3w2w
w2.+12.1w.13w
w.ww1.w...gww
ww2..w......w
w.2...2ww3..w
wwwwwwwwwwwww
