wwwwwwwwwwwww
w..w..1w.1..w
w123.....g2.w
w..www.w...1w
w2w.2+.w.w..w
w...2w.....ww
w3w.....w.w.w
ww...2.ww.A.w
wwwwwwwwwwwww
