wwwwwwwwwwwww
w1w.12212+..w
w...w..1.Aw2w
w.w.2...w.www
w3w23.w22...w
w..2.1.31..1w
w3w.....21www
w3w21g.1.ww.w
wwwwwwwwwwwww
