wwwwwwwwwwwww
ww2..3www2..w
w.23.wwwg1w1w
ww.A3.w3www.w
w...123.3w..w
w3w1w.w.w...w
w3...2.1w1.ww
w..w..32+1.2w
wwwwwwwwwwwww
