wwwwwwwwwwwww
w.3g..w222www
www1.w..333ww
w.3.1ww.32www
w1..121w1233w
w.w.wwA23.www
ww1+2.3w.w21w
w.2.3.3.2w.3w
wwwwwwwwwwwww
