wwwwwwwwwwwww
w2w..12w...ww
www3ww.2..w3w
w.g2ww......w
wA...1313w12w
w.3.w....ww1w
w112+w.3w2..w
w3.3.11ww...w
wwwwwwwwwwwww
