wwwwwwwwwwwww
w.2.1..w3..ww
w31.w....w..w
w+....3.2g1.w
ww3....3...1w
w..A3w3w....w
w.1w...1.2w.w
w..w.....2..w
wwwwwwwwwwwww
