wwwwwwwwwwwww
w...w131...+w
w12.3.131.1.w
w.1.w1...13ww
w.w.2..A.w3.w
w1.1.1213.23w
w.3.31..w12.w
w.1g..22w3.1w
wwwwwwwwwwwww
