wwwwwwwwwwwww
w.3..1w.w.21w
w.121+1.323.w
w2www.13..2ww
w....131w.3.w
w3.w21..31w1w
w12..1.3.13ww
wA12g2332331w
wwwwwwwwwwwww
