wwwwwwwwwwwww
w11...1w.w.3w
w2.31www.Aw1w
wgw13...2.2ww
w+1w.21.2...w
ww..11...w3.w
w.3w.2...32ww
ww.11.3w333.w
wwwwwwwwwwwww
