wwwwwwwwwwwww
w.w.ww.w1..1w
w3...112w323w
ww3...32ww.3w
w12w1.1.+...w
w221.w3...g.w
ww.2.1...3www
w..A..31w...w
wwwwwwwwwwwww
