wwwwwwwwwwwww
w..1..2.3.A.w
w..3.www.331w
w.w.w....1..w
w..113.w.3..w
w.12...23w.3w
w..w.1.w2.+gw
ww13..w11.w2w
wwwwwwwwwwwww
