wwwwwwwwwwwww
w2..w..w.2www
ww32..w.3w.1w
ww2..ww1....w
w3..3Awww3..w
ww.2+w.3.w3ww
wg..w.w21.1ww
w.3ww.1.w...w
wwwwwwwwwwwww
