wwwwwwwwwwwww
w2.2...w..3ww
w3w......3w.w
w...1.gw+w.ww
w3.w.2..w233w
w.232...w.13w
w3.w3w32.A.2w
w..w3ww.21w.w
wwwwwwwwwwwww
