wwwwwwwwwwwww
w.ww1.ww..w.w
w3w2w..w11w3w
w.w1wwwww..ww
w32.www213Aww
www1ww12w1w3w
w..3w3w.w.g+w
w.w.ww..3w..w
wwwwwwwwwwwww
