wwwwwwwwwwwww
w1.2.2122w32w
ww3ww13.ww3.w
w3.w2..3....w
w3.31...3.w1w
w3.w21w11Aw.w
w.gw..ww.3w.w
wwwww.w1..+3w
wwwwwwwwwwwww
