wwwwwwwwwwwww
w1...w.w.w33w
w...3...3ww+w
w.213w31.2..w
w.1w........w
w1w.1..3....w
ww3.g.wAw...w
w.w23ww32.www
wwwwwwwwwwwww
