wwwwwwwwwwwww
ww2.+.wwwww.w
ww23A.2.32..w
w3ww..gww.w.w
ww...33w..w.w
w.3.w31w..w1w
w113.3.w2w13w
w.ww.2w.ww21w
wwwwwwwwwwwww
