wwwwwwwwwwwww
w.w.......www
w1....w.ww2.w
w...ww.3..1.w
w.3322..2..ww
w1.2w.2..+.1w
w.1.....w.A1w
ww.wwg.2...3w
wwwwwwwwwwwww
