wwwwwwwwwwwww
w3ww2...wwg3w
w3.w.ww.ww2.w
w+.2w.3.w.A3w
w...1.......w
w..231www.2ww
w.2w.3w...w2w
w..3w...w3w.w
wwwwwwwwwwwww
