wwwwwwwwwwwww
wA1.ww...w.1w
w..wg3.22ww.w
w.ww131.3.w1w
w3.2..2.3+.3w
w.....221.1.w
w33...w..3.ww
w...w3.2w.w3w
wwwwwwwwwwwww
