wwwwwwwwwwwww
w.ww.wA1.w2.w
w1121.ww1.www
w3.3..13..3.w
w32.1w.2w322w
www3..g1ww2.w
w1...w1..22.w
w121.w+1w.2.w
wwwwwwwwwwwww
