wwwwwwwwwwwww
w1w2..ww1...w
ww.2ww.1....w
w.2133w3.13.w
wgw2...33.2.w
w22.w2.3+...w
w.3.3Aw..ww.w
w.ww.w...1w3w
wwwwwwwwwwwww
