wwwwwwwwwwwww
ww1.w3..w.1.w
wA...2w..w..w
w..w...3...1w
w.1.+.1ww2..w
w...3.3w2w.ww
w...w2ww.w.1w
www.g.1w...ww
wwwwwwwwwwwww
