wwwwwwwwwwwww
w323w.3...3.w
w1www312w.3.w
w3.3ww.w322.w
w.3A.+31.2w2w
wg122.33..1.w
w1w.w322www.w
w3w2w...w31ww
wwwwwwwwwwwww
