wwwwwwwwwwwww
w...A.w.12gww
w3ww.3w321..w
w1w1w.+23..ww
ww.w.3.3.w.ww
ww..2..3..1.w
w.2w.2w2w.22w
w...2ww3.13.w
wwwwwwwwwwwww
