wwwwwwwwwwwww
w2.222.1..w1w
ww2w.3..1.2.w
w1.w.w+32w.1w
w..ww2...21.w
w.w.22..3.3.w
w.13......w.w
w1g..wA...w.w
wwwwwwwwwwwww
