wwwwwwwwwwwww
w.A1.3...212w
w2.2.3w32...w
w321w.w.2.1.w
w13.g3...31.w
w1..w33.12.ww
w22...w+3...w
w.ww333..211w
wwwwwwwwwwwww
