wwwwwwwwwwwww
wwww11.1w...w
w3w.333w.w.2w
ww1.31w112www
w.1A22wg.13ww
w1w2..ww.3w.w
w313w..+2w2.w
w..3ww2ww..1w
wwwwwwwwwwwww
