wwwwwwwwwwwww
w3w.+.ww11w2w
w1..1..31...w
ww1..ww1w.1ww
w....w..w3www
www.ww..1.w3w
ww.332.1wgwww
w3..Aw1.3..ww
wwwwwwwwwwwww
