wwwwwwwwwwwww
w..2..g...2.w
w.........3.w
ww.......13.w
w2.2..12....w
w...+1....2.w
w.....3w.3..w
w3w2.A....3.w
wwwwwwwwwwwww
