wwwwwwwwwwwww
www3..w2.1..w
www1..w3133.w
ww12w321.11ww
ww.w.+www...w
w1..31.2.w..w
w1g32.....3.w
ww1...A.1.w.w
wwwwwwwwwwwww
