wwwwwwwwwwwww
w....2ww3.23w
w1ww.w+.3w3ww
w.3..3w1...1w
w.w..22w3w1.w
w1w..w2w.122w
w.wwwwA....1w
w3.21.w1g3..w
wwwwwwwwwwwww
