wwwwwwwwwwwww
wwg.w..w..1ww
www3w..w2.w.w
w1w1...2..22w
w.w..3..ww3.w
w.ww..A..3.ww
ww...w2+w..2w
w2..w1.3.1.3w
wwwwwwwwwwwww
