wwwwwwwwwwwww
www.3w...1.2w
w32w.ww....1w
w.ww.311.wwww
w.w2w13.11w.w
w23.www2.3www
w+.w.3.1gw.ww
w2.1Awwwwwwww
wwwwwwwwwwwww
