wwwwwwwwwwwww
w..ww+.ww.w.w
w...gw.ww.Aww
w31..w.3..22w
w.2.1.23.1.2w
ww.3..w.www.w
ww..w333..w.w
w...w1..wwwww
wwwwwwwwwwwww
