wwwwwwwwwwwww
w2w..1.3w.31w
w2.wg..1.w.ww
w.w3..A.w...w
ww.13..123.2w
w.........w.w
www22...+..ww
w.3..1w3w.w1w
wwwwwwwwwwwww
