wwwwwwwwwwwww
ww..3..w2..1w
ww..3w2.....w
ww..gw.w....w
w2..w+...131w
w........1..w
w....1.Aw.32w
w2.2..1.2w2.w
wwwwwwwwwwwww
