wwwwwwwwwwwww
ww.+.w311w.3w
w1w.3.1....ww
w2w.11ww22.1w
www33.g.13.2w
w.w.w3....1.w
w33ww12.wwA2w
w.2..12w1.w3w
wwwwwwwwwwwww
