wwwwwwwwwwwww
ww..w.3.3.11w
w12.321w.g2.w
w.w3331w1w2.w
w323...1.2.3w
ww32Aw112+.2w
ww22.w.ww.2.w
w13ww3w223..w
wwwwwwwwwwwww
