wwwwwwwwwwwww
wwww3w31.ww.w
w.2.w2..w311w
w332w.12w3w.w
wgw2.1..ww31w
ww..1.2...w.w
ww2.32+w3w..w
w.2..w.Awwwww
wwwwwwwwwwwww
