wwwwwwwwwwwww
w.wg.......1w
w231....w...w
ww.1.3.2w.1.w
w..A3....1+ww
ww.1111..1..w
w..2w1.w....w
ww..3ww.w22.w
wwwwwwwwwwwww
