wwwwwwwwwwwww
w13w2.1..g..w
w3...+w1223ww
w3w..3...2..w
w.w.33.2.122w
w2ww.ww11.12w
w3w332.13w2Aw
w13w..1w311.w
wwwwwwwwwwwww
