wwwwwwwwwwwww
w2.12...A.1ww
w.133.3.w..3w
wgw+..ww...ww
w31..w31.313w
w.w..3w.23w2w
w..221.3..1.w
w.w...3w3w..w
wwwwwwwwwwwww
