wwwwwwwwwwwww
w1w...1.2.3ww
w..3...313.gw
w3.+....w3w2w
w1..w3..w..Aw
w12.1w1.w.12w
w..w3.22.2..w
w.w1...w3...w
wwwwwwwwwwwww
