wwwwwwwwwwwww
w2.2.1.w..2.w
wA.2323.2.3.w
w.g313..w.w3w
w.w..1..w..3w
www.2.3..w21w
w.w2..3w3.w+w
w13w313w3.2ww
wwwwwwwwwwwww
