wwwwwwwwwwwww
w..1....w.2ww
w..w2w3ww.w1w
w....1..31..w
w+.w3.21www2w
www....1..1.w
w3.w3..w.w2Aw
w.ww3g.w32..w
wwwwwwwwwwwww
