wwwwwwwwwwwww
w.1......232w
wg..3332.A..w
w...1..1w331w
ww.31..111..w
w..222.13+21w
w3....13...1w
w...3131.2..w
wwwwwwwwwwwww
