wwwwwwwwwwwww
ww..1w2..2w.w
w...w..2.12gw
w..1.w..3w..w
w...A3221.w.w
w+1...1w13..w
w33..ww3....w
ww..3w3..12.w
wwwwwwwwwwwww
