wwwwwwwwwwwww
w.3g..w..w2.w
w1113.2.3w21w
w.3.3.131.w2w
w1A1ww+2.3..w
ww.2wwww3w31w
ww.1..3..32ww
w..2...131w.w
wwwwwwwwwwwww
