wwwwwwwwwwwww
w2ww23...1gww
w311.2.w31.2w
w+3.w3Aw2..2w
w2.w...2www2w
wwww3..1.223w
ww.w..w31.w2w
ww1.wwwww.www
wwwwwwwwwwwww
