wwwwwwwwwwwww
w.2.2..3....w
w.3.....3w3ww
w31A.w..w.12w
w.3+..2...31w
www.2.......w
w1..........w
w1.3.g.w22..w
wwwwwwwwwwwww
