wwwwwwwwwwwww
ww.w2w.1wA.ww
ww.w3w..2...w
w...21.ww.3ww
w..ww..ww2..w
w3.w.w+w....w
w3gw.3w2.2www
w...3.w.w.1ww
wwwwwwwwwwwww
