wwwwwwwwwwwww
w32w31g23.3Aw
w.w.w1www.2.w
ww..w...w..ww
ww...www3..ww
ww.3232..w+.w
w.w.....121ww
w.2..www3.w3w
wwwwwwwwwwwww
