wwwwwwwwwwwww
w.1..3..212ww
ww2..A3.1.w.w
w..w.2..1..+w
w23.1.w221.1w
w....3.212..w
w3.3w1..11.ww
w2.1..21.g21w
wwwwwwwwwwwww
