wwwwwwwwwwwww
w.ww...122..w
w2..g.3..+.ww
ww...3w....3w
w133w1.w2..1w
w.1.1.ww2.w.w
w1.1w.3.w.www
w33w.A2.ww1ww
wwwwwwwwwwwww
