wwwwwwwwwwwww
www....2g..3w
w..1.23ww1..w
w32...2.ww..w
ww2w31.1w2.1w
w3223A.12.32w
w2w...+ww2w1w
ww2.w1ww332ww
wwwwwwwwwwwww
