wwwwwwwwwwwww
w2.1.23..323w
w3www2.33.11w
ww3w.1..w.3.w
w3wA.g31w1.+w
w23.3w2..w1.w
w.3.....3..ww
w3...2.3.w.1w
wwwwwwwwwwwww
