wwwwwwwwwwwww
w.3.....w.1.w
w......3....w
w...2+33.21.w
w.A2...2.2g2w
w.1.33...22.w
w.3....1w..2w
w.12.2.3....w
wwwwwwwwwwwww
