wwwwwwwwwwwww
w3w13..w.12ww
w.+g2w.A....w
w...1332.w.ww
w.3.ww1..1w.w
w.1..113.w33w
ww1.13323...w
w.3123..32.2w
wwwwwwwwwwwww
