wwwwwwwwwwwww
w1w3..2..w+.w
w2w2..21w..3w
w.1..ww..1..w
w.ww.w2ww1A3w
ww3.g2w.2.3ww
ww.w..1w1w2ww
w11.w1w2..w1w
wwwwwwwwwwwww
