wwwwwwwwwwwww
w.1+w.....w2w
w211w...3...w
w1.1w..12.3gw
ww.A3.w..w13w
w.www32.w3..w
w..223...w..w
ww..23.ww2w.w
wwwwwwwwwwwww
