wwwwwwwwwwwww
w3w..3...w1.w
w2ww.2w12.A1w
www.w312.+w1w
w3...w...w.ww
ww....1.1.w3w
w.3w.g3w...ww
wwww3w2.w...w
wwwwwwwwwwwww
