wwwwwwwwwwwww
w.A....1...2w
w...w3+.w.3.w
w..1...w..3.w
w..1...w.w2.w
ww.w.2.w3..ww
ww..3w.g.wwww
www2.2.w2w.ww
wwwwwwwwwwwww
