wwwwwwwwwwwww
w....w.32ww.w
w311wg2w.w.3w
w3.w..w.3wwww
www..w.w32w1w
ww+1.Aw1w..2w
w1w.w11w2311w
ww1ww.21w2www
wwwwwwwwwwwww
