wwwwwwwwwwwww
ww...3w1w2.2w
w31ww.22www1w
ww.11.331w32w
w22w...w.w.Aw
www1222ww.w.w
w.www.w.gw.2w
w..1..w211+1w
wwwwwwwwwwwww
