wwwwwwwwwwwww
w3.2.w..w3.ww
w.w.w.w31A..w
w.w23.1..g.2w
w.w2+32....ww
w.21w.3w.33.w
w1..232....1w
w...w.2.13..w
wwwwwwwwwwwww
