wwwwwwwwwwwww
www1.w.1..w.w
w3w.2w..11w1w
ww..323.w2w2w
w.3.w.w12.w.w
wwAw..3.3w.2w
w2..1w..g..ww
w...w.1+1.3.w
wwwwwwwwwwwww
