wwwwwwwwwwwww
wA+....2.w..w
w23....31.3.w
w.1.13.ww13.w
ww...3.3.2g.w
w...2.1.....w
w...2.......w
w.w.w1.1....w
wwwwwwwwwwwww
