wwwwwwwwwwwww
w3...1.1..33w
w3w.Aw3w.31.w
w11.......12w
w.....2ww2..w
w.13.3...ww.w
ww+.w321..g3w
w..w..w.w...w
wwwwwwwwwwwww
