wwwwwwwwwwwww
ww2w1.3ww...w
ww.g.1.23.1ww
w.32..2.33.2w
w.w.22+.21.2w
w1ww.3..133ww
w.A31ww2w..3w
ww32.31.33.2w
wwwwwwwwwwwww
