wwwwwwwwwwwww
wwwww.w22..3w
w..121.13w3ww
w1w1w.3w..11w
w.222w23..w.w
w11.g.2.w..ww
w..ww2wA.ww2w
ww31+2.33..ww
wwwwwwwwwwwww
