wwwwwwwwwwwww
w.....2.w12+w
w..13.11w3..w
w..3.w..w.3.w
w....3..w...w
w...1.gw1..Aw
w..1.2.....3w
w..3ww...w22w
wwwwwwwwwwwww
