wwwwwwwwwwwww
w221..2..w2ww
ww22...w2.3.w
w1.+ww.gw.w.w
w.1.3.232...w
w.3..1..ww.ww
w.2.31.2.w21w
wA..11..3w2.w
wwwwwwwwwwwww
