wwwwwwwwwwwww
w..2w3..1.33w
w...ww11g.11w
w.2w3333121ww
ww13.1.2wA1.w
w31w2.3w2..ww
ww231.22.+.3w
w12.w.213w..w
wwwwwwwwwwwww
