wwwwwwwwwwwww
ww.1w13.w..ww
w13.Aw132w.2w
w.3.1.1221w2w
www...w32.1gw
w.w.2321...ww
w1...333.w3ww
w1....23+2..w
wwwwwwwwwwwww
