wwwwwwwwwwwww
w.23.1.13.2.w
w....+www323w
wA.33....w13w
w.3.1.3.g.3.w
w22.3...w.1.w
w...3.3.3w3.w
w12.3.213...w
wwwwwwwwwwwww
