wwwwwwwwwwwww
w.w2w22..+3ww
w1.2.3ww.13.w
w322w..22...w
w..3ww21A11.w
w2321.2123..w
w3.1......g3w
w.3....w.2..w
wwwwwwwwwwwww
