wwwwwwwwwwwww
wg2.2w3.332ww
w.w1..3w33w.w
w.23.13.A.13w
w.12........w
w3..13w.2+23w
w..3.www.33.w
ww13232w1w32w
wwwwwwwwwwwww
