wwwwwwwwwwwww
ww.12.ww1w2.w
w2.3w11.w..ww
w23w2w23.w.1w
wwww.w2w2.www
w2.1w.w31w3.w
wwwA3ww33..ww
w..1g33+.w1ww
wwwwwwwwwwwww
