wwwwwwwwwwwww
w12..2......w
w.2.A...g.21w
ww.23w.w.131w
w..1..1w1w32w
w3......w.w.w
w.1w.w...+12w
w31.3.3.1..3w
wwwwwwwwwwwww
