wwwwwwwwwwwww
w.w1223w23w.w
w..23w..2213w
w2223w.wAw.1w
w.3.1.+.w1..w
w.32.w..wgw.w
w33ww...1...w
w.22..w3.31.w
wwwwwwwwwwwww
