wwwwwwwwwwwww
ww..3..w....w
w.....ww1...w
w...3w1.ww.3w
w........w13w
w..w.13A.w.2w
w...g31w..w.w
w2.+2ww.ww..w
wwwwwwwwwwwww
