wwwwwwwwwwwww
www...31.w.ww
w..3..21.3w.w
w1...ww..313w
ww3..w.gw...w
ww...+3.w.w.w
w..1..ww.23.w
wA1...w..23.w
wwwwwwwwwwwww
