wwwwwwwwwwwww
w3+..wwww.w1w
w.112w33..23w
w.2..ww2ww.ww
www..w3.21.ww
w2.wA.w..g.1w
w...2w3...www
w3ww.3.1w3w.w
wwwwwwwwwwwww
