wwwwwwwwwwwww
w.3..21.3..3w
w13www1.w...w
w...ww...g31w
w13w3.w.31.ww
w.1w.1w+w.12w
w21w.22.1..2w
w2..A.w.112.w
wwwwwwwwwwwww
