wwwwwwwwwwwww
w..33.w..2..w
w32.w...3w2ww
ww.1w..g1.1.w
w..3w+3..2.3w
ww..23w21...w
w.12111www23w
www2A..23222w
wwwwwwwwwwwww
