wwwwwwwwwwwww
w..2...w3..2w
w1w12233.313w
www.1333A.3.w
ww.w3w3.21w.w
ww+3.w.232..w
w..3.11w2221w
w...w2.ww1gww
wwwwwwwwwwwww
