wwwwwwwwwwwww
w.3231...3..w
w.12.gw.+.www
w1w1ww1.23..w
w3..131.w2w2w
w321A.1.2.1ww
ww.23w.1.13ww
ww2.22.1.2w.w
wwwwwwwwwwwww
