wwwwwwwwwwwww
w2.....1....w
w...311.....w
w2211.3....1w
w1..3.1...32w
w.2...3A.2.3w
w..1w.1+g..1w
w32........ww
wwwwwwwwwwwww
