wwwwwwwwwwwww
w..1..2.....w
w...w3.22w.ww
w.w.+.......w
w..2.....3.3w
w...w.1.A.wgw
w.32.1....2.w
w.2........1w
wwwwwwwwwwwww
