wwwwwwwwwwwww
w1.11w+.22www
w.1www....www
wg311.2w.1w.w
w...1wwwww..w
ww..w2.2w.33w
wA.w..112..2w
w33.31.2.ww.w
wwwwwwwwwwwww
