wwwwwwwwwwwww
w1...w.....3w
w2w..1w322w.w
w1.1.g2..21.w
w2.w11w13w..w
w...3..1.w..w
w3.22.ww.1..w
w313.wA.2.+1w
wwwwwwwwwwwww
