wwwwwwwwwwwww
w.1.w1.w.2w3w
w2w3w1w32wwww
w2..13.w1g3ww
w.+3w32.3.A1w
w.13www.w...w
www2w121w11ww
w..1w3.1w.2.w
wwwwwwwwwwwww
