wwwwwwwwwwwww
w3.121A...3.w
w3w3w..w1..gw
w.w21.3..1w3w
w1w..123.13ww
w.1w2321.132w
ww3331.w....w
w131+..1.12ww
wwwwwwwwwwwww
