wwwwwwwwwwwww
w2ww3.ww....w
w....21.Aw1.w
w1.w1.1..3.3w
w..ww..3.g..w
w.ww13....1.w
w1...23.1..3w
w1.+32w....ww
wwwwwwwwwwwww
