wwwwwwwwwwwww
w.w..A......w
w..w.3w2..21w
w32....1.w3ww
ww1.1wwg...2w
w..+w.w.3w..w
www..2ww.1w.w
w.w.w2.1w3w.w
wwwwwwwwwwwww
