wwwwwwwwwwwww
w22..1.22.12w
w1+2.2..g2..w
w..2..12.1..w
w2...3.1ww1ww
w...2..2.A.1w
w1w3.3.w.132w
w.1...2..3..w
wwwwwwwwwwwww
