wwwwwwwwwwwww
w.w.33w.2w..w
w.3.+3.13.1.w
w1.1..13.211w
w.31.w1..w.1w
w.33w2.1Aw3gw
ww...w13..33w
w.3..w3.w3w.w
wwwwwwwwwwwww
