wwwwwwwwwwwww
w.3.22w...www
w.1.w..w2w.2w
w+w.w112w...w
w132.....wg.w
w122.....11.w
wA.1.ww..w3.w
w...2.....11w
wwwwwwwwwwwww
