wwwwwwwwwwwww
w....1..Aw.ww
w.3.2gww.3.1w
w.1..1w13w.2w
w..323....2.w
w.w.w...+1w3w
w23w.3...w.ww
w.w..2ww...1w
wwwwwwwwwwwww
