wwwwwwwwwwwww
w.2.3..1.w31w
w3....3.w1.ww
w1..w.1w3..3w
w21.w.3.321.w
w.3w.1.A2.+ww
ww3.2.1g1.w3w
w2.2..2.w1..w
wwwwwwwwwwwww
