wwwwwwwwwwwww
wwg.1w1....3w
ww...31w132.w
w.ww1.w.2w.ww
w31.1212www.w
w.w1w.32..w3w
w1.21w1.2.2ww
w..1www1wA+.w
wwwwwwwwwwwww
