wwwwwwwwwwwww
wwwww....w.ww
ww...w.ww.www
wwgw.w...w.1w
ww....w.2...w
w.1w.w.w....w
w+w.11.1..A.w
ww......w...w
wwwwwwwwwwwww
