wwwwwwwwwwwww
w.2.21w.ww.ww
www1w.3...www
w...ww.ww31ww
www..3w1w+w.w
w2.w..www.www
ww..w.ww3A.ww
w.w.ww.1.w.gw
wwwwwwwwwwwww
