wwwwwwwwwwwww
w.2322A..1.3w
ww2..3333gw2w
ww..23w...w1w
w2.1w13.2.+3w
w12w.3.2...3w
ww1221w3.w.3w
w2133w.2..13w
wwwwwwwwwwwww
