wwwwwwwwwwwww
w3...1.w1.w.w
w3...3.331.2w
w..1ww.2w23ww
w1+11..21Aw1w
w.w221.13.3.w
w121.w..w3.gw
w2.2..2..21ww
wwwwwwwwwwwww
