wwwwwwwwwwwww
w.w1.w.ww.www
w.....wAw2.ww
wwww1...11.3w
wwww23+.3w1ww
w.1.ww...2.2w
w.3ww..2..11w
w..3.gw3..11w
wwwwwwwwwwwww
