wwwwwwwwwwwww
w..w.3.1wg..w
ww3..1.w.1.+w
w.32w..13.w3w
w.31..3w3w12w
w.1..1.313.ww
w2.2.3..w12.w
w.21w..wA.w.w
wwwwwwwwwwwww
