wwwwwwwwwwwww
w......w.1wAw
w..2w1...w.+w
w..w...1.w3.w
w.w2........w
w.233w.w..w.w
w13.g...3...w
w.1..22.w.w.w
wwwwwwwwwwwww
