wwwwwwwwwwwww
ww..w.2....3w
ww1w...1..A+w
w1.1......w2w
w32...w...2.w
w..13..ww.1.w
wg1w2.2.w.3.w
w2....21..32w
wwwwwwwwwwwww
