wwwwwwwwwwwww
w...w...wg.ww
w.....w.ww.ww
w........w..w
www....w1..ww
w....A...wwww
w..........ww
w.wwww...+..w
wwwwwwwwwwwww
