wwwwwwwwwwwww
w.2g..2.1...w
w........1.3w
w..1.ww.3...w
w...........w
w3+..12.w..2w
w1....3.....w
w.......A...w
wwwwwwwwwwwww
