wwwwwwwwwwwww
w.w22w.2w1..w
www...1w....w
w.2.w+w.w.w.w
w.w123.2.w..w
w....w.g..w.w
w...ww..A...w
www.w..2w.www
wwwwwwwwwwwww
