wwwwwwwwwwwww
w+1.2...3..1w
w2.....3.w13w
w.32.121.132w
w..1.3.g..13w
w.....32w.3.w
w1......1..1w
w..3.3A.1..2w
wwwwwwwwwwwww
