wwwwwwwwwwwww
w....w....1.w
w.....2232..w
w.+3.3...2w.w
ww..3w3.11..w
w..3g....1..w
w.1w..w3.A..w
w.2.w...2w..w
wwwwwwwwwwwww
