wwwwwwwwwwwww
w2..2...w..1w
w.ww.ww.w13ww
w12......w3ww
w+..2..w.1.1w
w33ww.......w
w3.3gw.22.w3w
w..21..wA231w
wwwwwwwwwwwww
