wwwwwwwwwwwww
w1.21.3.....w
w...1+.2A...w
w......2....w
w.......w2..w
w.w.2.....w.w
w11.3w...2.gw
w.31...12...w
wwwwwwwwwwwww
