wwwwwwwwwwwww
w1ww12ww1w.ww
w.w22ww.w3g2w
w23.3131w.2ww
w+.w3w1w..32w
w1.321A..w1.w
w1w2....12.2w
w3w2...w2.www
wwwwwwwwwwwww
