wwwwwwwwwwwww
w3..3g..A..3w
ww....w+.3.1w
w.......ww.2w
w..w........w
w......22.3.w
w3...2......w
w...w....2..w
wwwwwwwwwwwww
