wwwwwwwwwwwww
w31.3w..1..ww
ww.....g.1.1w
ww......+..Aw
w.w1...w....w
w..2.22w212.w
w3...2...1.3w
w..ww....w..w
wwwwwwwwwwwww
