wwwwwwwwwwwww
w2www.wwg..1w
w23w.w.3.ww.w
ww.3w.w...w1w
w.w..1.w.3+ww
www....w.wAww
w..2......www
w1w...ww...ww
wwwwwwwwwwwww
