wwwwwwwwwwwww
wgw.+..2w..ww
w.w.w.wwww1.w
w...1.A.....w
w.w..3..w3www
w1..2.3www.ww
w..w.ww1.ww.w
w.ww13wwww..w
wwwwwwwwwwwww
