wwwwwwwwwwwww
w.w1.....2.ww
w1...ww.2w.ww
w.w.+2....w.w
w2..3..w.w.ww
ww.w.w3ww.gww
wA.33.w.....w
w..w....w..ww
wwwwwwwwwwwww
