wwwwwwwwwwwww
w..22......ww
ww...ww.A...w
ww..1..w.wwww
ww..w...g.1ww
ww...w...wwww
ww.w2..2.w1.w
w1.w..ww.+..w
wwwwwwwwwwwww
