wwwwwwwwwwwww
w3.ww2w..1..w
ww.....w..w.w
w.w1w..ww..ww
w1..www.A...w
w1w.w33..ww.w
w...w1..g.w.w
w.+.....ww..w
wwwwwwwwwwwww
