wwwwwwwwwwwww
w3w2.31.23.2w
w2...13...3+w
www.g11w2..2w
w3.3.321.1w.w
w.1..1.3w31Aw
ww..2122...3w
w33w2.1w.22.w
wwwwwwwwwwwww
