wwwwwwwwwwwww
w.ww..2..3.2w
w2..33...22ww
w21.13.2..31w
ww2w121213A+w
w....w3.w.w.w
w.3.1..11.1.w
w123..12211gw
wwwwwwwwwwwww
