wwwwwwwwwwwww
www...32.21.w
w.3.A.w...1ww
wwwww.w2....w
w.w......1+ww
w.w..w.w..33w
w3w..ww...2ww
ww3wg3.ww2..w
wwwwwwwwwwwww
