wwwwwwwwwwwww
w2...g2..w..w
w.2w..2....3w
w.....w1w...w
w..2..3+2w..w
w1w..33w3...w
wAw..1...2w1w
w..1.2ww.2.3w
wwwwwwwwwwwww
