wwwwwwwwwwwww
w.w.3......Aw
w........w..w
w....w...+w.w
w.w...1...w.w
w1.....w....w
w..........ww
ww..g.....www
wwwwwwwwwwwww
