wwwwwwwwwwwww
w2....3w..3.w
w3.........3w
w.w..g.....1w
w..w....A3..w
w...1w1+.w..w
w.3.......w1w
ww..w2.w....w
wwwwwwwwwwwww
