wwwwwwwwwwwww
w....w.1..w.w
w.g.wA.2.w..w
www...w3.w..w
w.w.2.......w
w.....2...w.w
w+.w.w..ww.3w
w.w.....2w1.w
wwwwwwwwwwwww
