wwwwwwwwwwwww
w2........w.w
w...w.2.w..+w
w..w.....3..w
ww..A.1..w.ww
w.w1..2.....w
wwww.11ww..gw
w..3.......ww
wwwwwwwwwwwww
