wwwwwwwwwwwww
w..w....1w..w
w.w2w..w.2..w
w..3www1.w..w
wg..w......1w
w.....3.w31.w
ww..w.w..+2ww
w...2.wA1...w
wwwwwwwwwwwww
