wwwwwwwwwwwww
w........+3.w
w2.....2.1.ww
w......w...3w
w.......1...w
ww1w3.2.....w
w...1wA3....w
w.2w.3....3gw
wwwwwwwwwwwww
