wwwwwwwwwwwww
www.www.w.w.w
ww.w.w.1w..ww
w3..w.w....ww
w.w.www.+w.2w
ww..3.2.w.3.w
w3..1w3w...ww
wAgw..3w3.w.w
wwwwwwwwwwwww
