wwwwwwwwwwwww
www....+ww..w
ww.w221.w...w
w...w....ww.w
ww3w.3...w..w
w2..w..1w1wAw
w.ww....w3..w
w..2.3.1.g..w
wwwwwwwwwwwww
