wwwwwwwwwwwww
w..21.w.32.3w
wg....w.23.1w
w..w.1...3.3w
w...2..2..3.w
w2112.w.1.2.w
w2w.w22..w12w
w+.12.1.2.A.w
wwwwwwwwwwwww
