wwwwwwwwwwwww
w........w..w
w...........w
w....+...w..w
w....w.ww...w
w..g........w
w......w....w
w..w.w..A...w
wwwwwwwwwwwww
