wwwwwwwwwwwww
w2ww.......ww
w1.1+.w...g.w
w3A3..w..w..w
ww.2.w......w
ww....w...w.w
ww21...www..w
w...1.3...www
wwwwwwwwwwwww
