wwwwwwwwwwwww
w.322...1322w
w..31231.22.w
w32A.3.212..w
w1.1.1.11..2w
w.+.3..g1322w
w..312.33.32w
w3.1...122..w
wwwwwwwwwwwww
