wwwwwwwwwwwww
w...........w
w...w.......w
w...........w
w.......g...w
w.A....ww...w
w..w..+...w.w
ww..........w
wwwwwwwwwwwww
