wwwwwwwwwwwww
w1.2.2.w2g.1w
w.33.33w32w3w
w.wwA321....w
ww..3.w1w3.+w
w..w.www2.w2w
w.22233..221w
ww2..3w3ww.ww
wwwwwwwwwwwww
