wwwwwwwwwwwww
w3..w.w.ww..w
w.32..2...www
w2...w1.2w2.w
www.w3w2.wwww
w1...w1ww2..w
w.w2...w.w3ww
w2.+gwA.ww..w
wwwwwwwwwwwww
