wwwwwwwwwwwww
w32w2.w..3+1w
w3.121w3...gw
w.1..32...23w
ww2311.2...1w
w1.33w.2w.22w
wA..ww.w22.ww
w2.www.2.3www
wwwwwwwwwwwww
