wwwwwwwwwwwww
ww2w.w+121www
w.Aw.23..2www
ww..w..3.w1.w
w...w.2w.ww.w
ww3..wgww.1ww
ww.w.w1.ww2ww
ww.w.3.w...ww
wwwwwwwwwwwww
