wwwwwwwwwwwww
w2g.231.w.32w
w..w..+3..13w
w.1221.....ww
w.131..2w.31w
w1.32...21..w
w3.A..3w.ww.w
w.312..2..22w
wwwwwwwwwwwww
