wwwwwwwwwwwww
w....w.3....w
w...3....w..w
w...+.w...w1w
ww23....w3..w
w.....w.....w
wg...1.....Aw
w1..w..2...2w
wwwwwwwwwwwww
