wwwwwwwwwwwww
w..321.1w3..w
w1..12.22+1.w
w12w.1.3.3..w
w.3w.13.w112w
w.3g33..11..w
w....1..2w2Aw
w311..ww.w13w
wwwwwwwwwwwww
