wwwwwwwwwwwww
w13.2w.2.w..w
w2..1.322.3ww
wA....1.w.2.w
w.....w.w...w
w3...1w.....w
ww..w3w..+wgw
ww.www.3....w
wwwwwwwwwwwww
