wwwwwwwwwwwww
w+2ww....w.ww
ww.w..w3.w..w
w...g......ww
w...w1w...1.w
www....w.w.3w
w.1.A3.w.w.2w
w..ww..2.1..w
wwwwwwwwwwwww
