wwwwwwwwwwwww
w.....w.....w
w....gw.....w
w.......ww..w
ww...wA..3w.w
w..w+...w.w.w
w.w.2.www...w
ww..........w
wwwwwwwwwwwww
