wwwwwwwwwwwww
w.w.2w..w...w
w.1wwwA.ww..w
w1..w.1...www
ww..w.www...w
w..ww2gw..w.w
w...w.......w
ww.w.1w...+.w
wwwwwwwwwwwww
