wwwwwwwwwwwww
w.w.322....1w
w12.3..3....w
w2www.w12..ww
w.1....+3.3.w
ww2.3A.1.wwww
w3..23.1....w
ww11g.2.1.2.w
wwwwwwwwwwwww
