wwwwwwwwwwwww
w.....2.....w
w2w......w..w
wg..2.....w.w
ww..www.....w
ww...2A...1.w
w...1w..w.2.w
w........+..w
wwwwwwwwwwwww
