wwwwwwwwwwwww
ww1..w..2A..w
w...........w
w...3.....2.w
ww...+w....2w
w..ww..w....w
w....2..w.3.w
w....2w.gw..w
wwwwwwwwwwwww
