wwwwwwwwwwwww
w.+.2.12www.w
w1..ww22Ag31w
w.3w1w.w3...w
www......wwww
ww1.3..2..22w
w.1w..2w2.31w
w.2.2w.w..www
wwwwwwwwwwwww
