wwwwwwwwwwwww
w.333..2w...w
w2..w.32.233w
w.3...w2..3.w
w..+..1g1.2.w
w1....A..2..w
w1.3.w3.....w
w.1w3w2.2...w
wwwwwwwwwwwww
