wwwwwwwwwwwww
w2.wgwA...w.w
w.w....w.1www
w.w+....ww.3w
w..wwwww.wwww
w3www.w.....w
w3ww1wwww2.ww
w.1ww.1.w.w2w
wwwwwwwwwwwww
