wwwwwwwwwwwww
ww.www23w2w.w
w.33g2.313.ww
w22w.w.21w21w
w3w3w2w.1+w1w
ww.w.3.3.1.1w
w231A1...211w
w.w..w332.www
wwwwwwwwwwwww
