wwwwwwwwwwwww
ww2......w.ww
w1..w.w31..ww
w.w13ww.w..Aw
ww.w.3.w.w1+w
ww..ww.w....w
www2w..w.w1gw
w1.3w...22w.w
wwwwwwwwwwwww
