wwwwwwwwwwwww
w112w1.1...3w
w.322.w3.3.gw
w.A1112.w.33w
w1.w..1.33..w
w3ww.w.222.2w
www1..322333w
ww..w.132w.+w
wwwwwwwwwwwww
