wwwwwwwwwwwww
w..3111...2.w
w......232.3w
w.3.....3133w
w....3.3.1..w
w..2.1221...w
wA.2.121..+.w
w..23321.2g.w
wwwwwwwwwwwww
