wwwwwwwwwwwww
ww+...ww.33ww
w....1323.3.w
w.2g...1w.3.w
w..w..ww..w.w
w1w...ww3..ww
w.2..A.www21w
w...www.w1.ww
wwwwwwwwwwwww
