wwwwwwwwwwwww
w333.ww..1.1w
w12w...1w.www
w.1.133w...3w
w3..w+....w.w
w.w...A.1.1.w
ww.2..31w.w2w
w...g2.w...ww
wwwwwwwwwwwww
