wwwwwwwwwwwww
w.ww1....w..w
w1w2..ww1w1ww
w2g.www...www
www+.ww.w.w.w
w.wwAw...ww.w
wwww..www...w
w.w2ww3w2.3ww
wwwwwwwwwwwww
