wwwwwwwwwwwww
w...w.....w+w
w...........w
w...........w
w..........Aw
w...........w
w.......g...w
w.w.....w.w.w
wwwwwwwwwwwww
