wwwwwwwwwwwww
w...2.12g.3ww
w....1....w.w
w..2.......1w
w....w11w.1.w
w...22w.w3..w
w.1321...2.Aw
w.1..23...1+w
wwwwwwwwwwwww
