wwwwwwwwwwwww
w.1..ww..w..w
w1.3.3.w3w.gw
w13w.3...w..w
w....w......w
w31.32.2www.w
w1.2.2...w.Aw
w1..+..3w3www
wwwwwwwwwwwww
