wwwwwwwwwwwww
w231...3.2.ww
w.2.1.1w...1w
w..3.1213.31w
w.3w221.3.1gw
w1...111222+w
w1123.23.1.Aw
w.3....2....w
wwwwwwwwwwwww
