wwwwwwwwwwwww
w.21.....w.Aw
w..w.w2w..w.w
ww....3.....w
w.w......w.ww
w.w..2.w...ww
wwww.1wwwgw.w
w...w.+...w.w
wwwwwwwwwwwww
