wwwwwwwwwwwww
w.2.www..g1.w
w..2w.w12w2.w
w.1.www.w2..w
ww23..w.11w2w
www..13Aw+.ww
w..3.w..1.w.w
w.3w.wwwwwwww
wwwwwwwwwwwww
