wwwwwwwwwwwww
w.....2.A2..w
w.......3.w.w
w1w.w1......w
w...gw......w
w..1.2..w...w
w..w.......1w
w..2......+.w
wwwwwwwwwwwww
