wwwwwwwwwwwww
w2212...2..ww
w..3w1..2..3w
w........1..w
ww32........w
w3A.2...3...w
w+..23..g332w
w1...1....2.w
wwwwwwwwwwwww
