wwwwwwwwwwwww
w.........w3w
w...w.......w
ww..w......1w
w..+......w.w
w.1..3...A..w
w.w.......w.w
wg.......1..w
wwwwwwwwwwwww
