wwwwwwwwwwwww
wgwA2....2.2w
w..23w.3...2w
ww3.ww..w1www
w.3..3...w33w
ww2w1..w+.w.w
w.....1.333ww
w1.2.ww..1www
wwwwwwwwwwwww
