wwwwwwwwwwwww
w..w..w....3w
w2..3.......w
w.3w..w.w...w
ww.wg2w..ww.w
w+w...3.2..3w
w.w..3w32...w
wA..w.w.w3w.w
wwwwwwwwwwwww
