wwwwwwwwwwwww
w...2......1w
w....3w.2..ww
w.133..3w..1w
w2.3...3w...w
w3g331..A.+3w
w..........2w
w.......1...w
wwwwwwwwwwwww
