wwwwwwwwwwwww
w.ww..w3+w.ww
w2...2....www
w.w2..3w.w1.w
w.g..2......w
wwww.w.A.ww.w
w.1....w..www
w.w.w1w..w.2w
wwwwwwwwwwwww
