wwwwwwwwwwwww
w1..1w.wA..ww
w1.1..ww.w31w
w2..332.323ww
w3w11333w2.ww
w3w31....w12w
w.3.+1www32.w
ww33.33wwg.1w
wwwwwwwwwwwww
