wwwwwwwwwwwww
ww2.1..23A.3w
ww.w1..3..1ww
ww.+.1.w2.3.w
w11..23w122ww
w.2ww321...gw
w11.2...2.2.w
w...w.2.w.23w
wwwwwwwwwwwww
