wwwwwwwwwwwww
wA.3g.+..1..w
w..2w313w1.2w
w.3w2223.213w
w22.1w.w3...w
w..w.1w12w.ww
w1.12w22332.w
w21w.322.2..w
wwwwwwwwwwwww
