wwwwwwwwwwwww
w......Aw.1.w
w..112ww....w
w....3.w..w.w
ww..w.3w.2..w
w..w1w..1.1.w
w1.2..www..ww
w.1wg+www...w
wwwwwwwwwwwww
