wwwwwwwwwwwww
w.2w..w.3w.1w
w.32w....32.w
w.1w.g..1..ww
ww.w1...w...w
w..3w.312w.ww
www.3w..w..3w
w.w1w.A.+..1w
wwwwwwwwwwwww
