wwwwwwwwwwwww
w..w....3g.ww
w.3w.....23.w
w..w.+.w2..ww
w...1www....w
w..31w11...ww
w.w.1w.w2w.1w
w.21.wA.w..2w
wwwwwwwwwwwww
