wwwwwwwwwwwww
w3..3..3w112w
w...213.2g2.w
w..1w......ww
w11.w3.w231.w
w...111...w1w
ww.12w213...w
w....ww1.+.Aw
wwwwwwwwwwwww
