wwwwwwwwwwwww
w.2..3w.A...w
w3.........2w
w....w......w
w.2.11w...w.w
ww..1...w3..w
w3..g..w.w.+w
w.....33.2.2w
wwwwwwwwwwwww
