wwwwwwwwwwwww
w...1.1132w.w
ww22..w1.+.1w
w..w3.3..313w
w.1.w.1..w..w
w1w3.A.2....w
w.23..w..ww.w
w..w.w3g....w
wwwwwwwwwwwww
