wwwwwwwwwwwww
w2w2..www1www
w11..2...1.1w
w+w.w2.2ww.3w
wAw1...www.ww
w....2.www.gw
w.......ww..w
ww2w.23.21.2w
wwwwwwwwwwwww
