wwwwwwwwwwwww
w....+2.1w..w
w3.33w.1.2w.w
w..g.w33.2w.w
w..2.A.w3w3.w
w...33ww.1.2w
w.2..33.3...w
w1w.w2..1.31w
wwwwwwwwwwwww
