wwwwwwwwwwwww
ww1.1.1.w.11w
w.13....3...w
w+.w.2..3...w
w.122...32..w
w1.Aw.....3.w
w....1.g....w
w2.2.w....w.w
wwwwwwwwwwwww
