wwwwwwwwwwwww
ww3w31...w2ww
w22ww1w32w3.w
w2.1wgw2w2w.w
w.22.21w...1w
ww..2w3.3.+.w
ww..www..3.3w
www2w.w.3.A1w
wwwwwwwwwwwww
