wwwwwwwwwwwww
w...........w
w.....w...1.w
wg........3.w
w..1........w
w...........w
w.....A2....w
w......2..+.w
wwwwwwwwwwwww
