wwwwwwwwwwwww
w.1......3.ww
w...w.wg.2.ww
w...112...1.w
w3+.www.www2w
w....2.....3w
w.....3.2.1.w
w....3.ww..Aw
wwwwwwwwwwwww
