wwwwwwwwwwwww
w32...ww3..Aw
w.ww3wwwww..w
w1w.12.22w.ww
w.1..21w..33w
ww2...2w.33.w
w.131.w1+2w2w
w3..1.2g.12.w
wwwwwwwwwwwww
