wwwwwwwwwwwww
w13..1+3w.w.w
ww21w1..w...w
ww..Awwww...w
w11.21..132gw
www.32.3w.3.w
w1..ww1.2w1ww
ww......w3..w
wwwwwwwwwwwww
