wwwwwwwwwwwww
w131w.w.2A3.w
w112.1w.1w.3w
w1.3w213..33w
w2...w.33..3w
w...w311232.w
w.g221..3.21w
w..1.212+.w3w
wwwwwwwwwwwww
