wwwwwwwwwwwww
w...ww3231w3w
w.w...1wg.33w
w...3w..w3..w
w3..2wwww2www
w.wAwww3.w.ww
w31223+1w.3ww
ww.12w.ww223w
wwwwwwwwwwwww
