wwwwwwwwwwwww
w......w..www
w..w...w..w.w
w.ww......w.w
w..g.wwA...ww
ww.....w....w
ww......w...w
w.w..+..w...w
wwwwwwwwwwwww
