wwwwwwwwwwwww
w23w2.1...1.w
w.+13.....2.w
w..w.w2.1...w
w32..1.2..2ww
w......1...gw
w.1w...ww2..w
w11A...w...2w
wwwwwwwwwwwww
