wwwwwwwwwwwww
w3..1.2...2.w
w.32.w2w1233w
w.1w.w..w.w.w
ww22..23.23.w
w..2..2w331.w
w21g.2.3..3.w
w2....w2w+Aww
wwwwwwwwwwwww
