wwwwwwwwwwwww
ww..........w
w...........w
w.....w.....w
ww....w.....w
w..w.w.w...ww
w+A....gww..w
w..w...w....w
wwwwwwwwwwwww
