wwwwwwwwwwwww
w....Aw...2.w
w....w..w...w
w........w..w
w....+..ww.ww
w2...w.w....w
w.w.g.w.w..1w
w...w..w...ww
wwwwwwwwwwwww
