wwwwwwwwwwwww
w.gww+..w2w1w
w..2221.1..3w
w...2w..w..ww
w1...31w..1ww
w.ww..11www3w
ww..12.1A3w1w
w.....1..w1.w
wwwwwwwwwwwww
