wwwwwwwwwwwww
www...2...1.w
w...+w.w..w1w
ww....wg...1w
w.32.w2..2.2w
w..1.3A.....w
w..w..2...www
w1....w....ww
wwwwwwwwwwwww
