wwwwwwwwwwwww
w....3....12w
w.3....2..g1w
w32.2.2.1231w
w1w3.3...3A2w
w311.1..3113w
w23+123...2.w
w121...1.2.3w
wwwwwwwwwwwww
