wwwwwwwwwwwww
w..www1w.1.2w
wwww2g3..3.2w
ww...1www..ww
w.ww.+1..ww.w
w..www..w2.ww
w3w..w.w..1.w
w....w.A..3.w
wwwwwwwwwwwww
