wwwwwwwwwwwww
www2w.w2.w+.w
w.1.wg...ww.w
ww...132w.w.w
w.22ww..1w.Aw
w.w....w..w.w
w2..w1w2.ww1w
wwww2ww3131.w
wwwwwwwwwwwww
