wwwwwwwwwwwww
w..1........w
ww.A3213....w
w.2...w3.3.ww
w..+...g.31.w
w.1.........w
w.1.....213ww
w...2.......w
wwwwwwwwwwwww
