wwwwwwwwwwwww
ww.+.2w.w1w1w
w11..3.3.3.ww
w3w..g.wwww1w
ww122ww31.www
w2w.2.1.122.w
w.2.22.w.11ww
w2..32A312w.w
wwwwwwwwwwwww
