wwwwwwwwwwwww
w.www1.w.1.1w
w11..w.1w.11w
w1.w...3..2.w
wA...1.32...w
w+..1w213.33w
wg.23.w..ww.w
ww13..11.1..w
wwwwwwwwwwwww
