wwwwwwwwwwwww
ww.......w.Aw
w...........w
w......ww..gw
w...........w
ww......2...w
w....w.....+w
w...........w
wwwwwwwwwwwww
