wwwwwwwwwwwww
w33....2131.w
ww.w12..1w3.w
w......333..w
w1ww.ww.2+3.w
w.w....33w.gw
w.wA1w3..221w
ww22.2.w..13w
wwwwwwwwwwwww
