wwwwwwwwwwwww
w...ww.3w.w.w
w1w.Aw......w
w.w.w+ww..3.w
ww.2....3ww.w
w..21g..1w..w
w2ww....2...w
www.ww......w
wwwwwwwwwwwww
