wwwwwwwwwwwww
w.w..1...+3.w
w.2.12..A111w
w.23..1.2w..w
w.w.3.w..ww.w
w..11...2w.ww
w...3w.ww.3.w
ww.g1..w..www
wwwwwwwwwwwww
