wwwwwwwwwwwww
w..w..1w..3ww
w...+w.w.w..w
www.w.w2..w2w
ww23.w2.w1.1w
w..3.1A...www
ww.w..1w..www
wg.....w...ww
wwwwwwwwwwwww
