wwwwwwwwwwwww
ww......w...w
ww......2...w
w.w.....3...w
ww...wgw..w.w
ww+1.....w3ww
w.ww.w.ww.www
w.A....1..3.w
wwwwwwwwwwwww
