wwwwwwwwwwwww
w..w..g....1w
ww31.w.wA1..w
w....2.w...ww
ww3.11..w..1w
w.ww..w113w2w
w.ww.31+12.ww
w33.212w....w
wwwwwwwwwwwww
