wwwwwwwwwwwww
w.3...gww.2.w
w.w..11.2w.2w
w1.ww..113w3w
ww..w2..w.3.w
w1......13.2w
w1w.1w1+.ww2w
w.A.1..1w2.ww
wwwwwwwwwwwww
