wwwwwwwwwwwww
ww32.ww.www.w
w.1.12+wwww2w
w11wwww3..A.w
w2g.313www..w
w1www332.121w
ww.32www32.3w
w.1w2.1ww..1w
wwwwwwwwwwwww
