wwwwwwwwwwwww
ww..33.1.w1.w
w..A.3.3w.w2w
w2.w.ww..w.gw
w...ww.w3w3.w
w3.+321...1.w
w1.1..w....ww
w1w...3ww.www
wwwwwwwwwwwww
