wwwwwwwwwwwww
w....+2....2w
w...3....3..w
w...........w
w.3...2....gw
w.......3...w
w...A....2..w
w1..........w
wwwwwwwwwwwww
