wwwwwwwwwwwww
w...........w
w...........w
w.......+...w
w...........w
w...........w
w...........w
w.Ag........w
wwwwwwwwwwwww
