wwwwwwwwwwwww
w22wwwA..ww.w
w..221g+.wwww
w.w3www.w32ww
w3w22w..ww1.w
www.www2.1w.w
w3.2.1ww.w1ww
w.22.w3ww.w.w
wwwwwwwwwwwww
