wwwwwwwwwwwww
w.3.+w.ww..1w
w13....w3.1.w
w.w3.1.w..wgw
wA2...13ww..w
w..13332w..2w
w21.wwwww.w1w
w2....13...ww
wwwwwwwwwwwww
