wwwwwwwwwwwww
ww2w33w1.1.3w
ww1w.....2..w
ww23w..1.w32w
w.w+w.www2.gw
w12.2.w13w..w
www13w..3...w
w.1w.....A..w
wwwwwwwwwwwww
