wwwwwwwwwwwww
w...........w
w...........w
w........w1.w
w..g...1....w
w3.A.....+..w
w.....w.....w
w....w......w
wwwwwwwwwwwww
