wwwwwwwwwwwww
w.2..2.3..www
w2w.A.......w
w...wg.3..2ww
ww......1w33w
w.w313...3.ww
w3w+.1....w.w
w...2.w.w...w
wwwwwwwwwwwww
