wwwwwwwwwwwww
w...........w
w..2........w
w+..........w
w...A...g1.2w
w...........w
w...........w
w.......3...w
wwwwwwwwwwwww
