wwwwwwwwwwwww
w2w23w.2w.33w
w3.13.31w+..w
w3311w..3.11w
w23....w....w
w223ww213A..w
w.1w.wg.233.w
w3...w21w2w1w
wwwwwwwwwwwww
