wwwwwwwwwwwww
w..ww3w..1+gw
w.333w.1w..2w
ww1..1..2wA2w
w.2w222.2w.1w
ww...11.31.ww
w.2..2w.1.2.w
ww3.1ww....2w
wwwwwwwwwwwww
