wwwwwwwwwwwww
w.+.........w
ww....w.....w
w...2..1w...w
w.w...A.w...w
w.ww.1....www
w...1....2.ww
w.w.2..w2g..w
wwwwwwwwwwwww
