wwwwwwwwwwwww
ww...w21..w.w
wA12212w.w.1w
w12.23.ww3..w
w...3.+12113w
w.w23w1....1w
w1w.2w...w3.w
ww221g.2.wwww
wwwwwwwwwwwww
