wwwwwwwwwwwww
w..2+.2..w.2w
w3..1.A2..2ww
w..w1....wwww
w.gw..w2...2w
w..w......www
www3311..w..w
w....w.311w.w
wwwwwwwwwwwww
