wwwwwwwwwwwww
w.....w1www+w
www.w.w..1.3w
w.....w.ww..w
w3..w..2w...w
w.........www
ww..A....ww.w
ww....w..g.ww
wwwwwwwwwwwww
