wwwwwwwwwwwww
wgw31....1w.w
w3..+ww3...3w
w31..3.w.w3.w
www.1.w.2.1ww
w222...12.www
w..A31131.w.w
ww.w2.3.3333w
wwwwwwwwwwwww
