wwwwwwwwwwwww
w.23w...1g.+w
w2.w.....3..w
w......w...ww
www.ww1Aw..ww
w..www1w...ww
w.....ww.2..w
w1....21..w2w
wwwwwwwwwwwww
