wwwwwwwwwwwww
w.3...3.2.33w
w.w.w..w.2Aww
w.1....www..w
w...w.....1.w
wg....1.1..ww
www.3.+....ww
w....w1wwwwww
wwwwwwwwwwwww
