wwwwwwwwwwwww
w221.wg.11.2w
w2w2.23w1.1.w
w.3..1..w111w
w332..w213..w
w.w.2332.321w
w3..32..3..Aw
w.2.w131.2w+w
wwwwwwwwwwwww
