wwwwwwwwwwwww
w.3w3.1..2..w
w..w.ww.ww..w
ww.w..w2.w.ww
ww....ww...+w
ww...w......w
w..Aw..w.ww.w
w1g2w.w....ww
wwwwwwwwwwwww
