wwwwwwwwwwwww
ww22.3w2..w.w
w2.w1+wwwwwww
www..1w1gwwww
w33w3312w..ww
www3w.23...Aw
w1ww3.22w21ww
w2.ww22..3w.w
wwwwwwwwwwwww
