wwwwwwwwwwwww
w..g..31...1w
w..3..2.3213w
w31.1...2.11w
w.31...3A1..w
w3......3223w
w..+.2...3..w
w21..31..2..w
wwwwwwwwwwwww
