wwwwwwwwwwwww
w...........w
w........1..w
w........A..w
w.+........gw
w...........w
w.3.....2...w
w...........w
wwwwwwwwwwwww
