wwwwwwwwwwwww
www.2w.32ww.w
w3w.33..2332w
w1w.3.w2...ww
w2w2+w.2.122w
wwwAw2.w..www
w3123www..2ww
w3.3g1.21.w.w
wwwwwwwwwwwww
