wwwwwwwwwwwww
w1+2.1.1.1.2w
ww2w21.33.31w
w.13w..A..1.w
ww.3.w..3...w
w.wg...w.w.ww
ww.www11w.1ww
w.1.2ww3ww3ww
wwwwwwwwwwwww
