wwwwwwwwwwwww
w.w2w.w.1123w
wA1.2.1..1g.w
w.w1w..13w.1w
w..w.1w....3w
w1.1w.3..3..w
w....w..3...w
w...+w1.....w
wwwwwwwwwwwww
