wwwwwwwwwwwww
w3w.w....w..w
ww...w1.ww.ww
w.w......w.ww
w1..2w11w.3.w
w1gww....1.2w
w..w.3.w2w23w
w.A....+w.www
wwwwwwwwwwwww
