wwwwwwwwwwwww
w.3w.w..wgw.w
ww.www3211.2w
w.w.3ww23.3ww
ww.3wwA2..3+w
w3w3.w.w..3.w
ww33..w321w3w
ww.w2.w2.w2.w
wwwwwwwwwwwww
