wwwwwwwwwwwww
wgw11....2w.w
w2..2ww+...2w
w2...1.w.w1.w
www.3.w.1.3ww
w.32...23..ww
w..A13.21.w.w
w..w3.2.3131w
wwwwwwwwwwwww
