wwwwwwwwwwwww
w..2.....w11w
w...3..2.ww.w
w..w.w2.1+..w
w.ww...13..2w
w2..wg.1wA..w
w...w....1..w
w...1w..w1..w
wwwwwwwwwwwww
