wwwwwwwwwwwww
w.www..www.ww
w.322..w.w.ww
ww2ww.12.2www
w.w3..1.+.12w
wwgAw2www3www
w3.ww11w.1w.w
w...ww3ww3.ww
wwwwwwwwwwwww
