wwwwwwwwwwwww
w....31..2..w
w..........gw
w...A.......w
w...1.....3.w
w...........w
w.....2+....w
w....1......w
wwwwwwwwwwwww
