wwwwwwwwwwwww
w...........w
w......A....w
w2..+.......w
w.......g...w
w...w.......w
w........w..w
w...........w
wwwwwwwwwwwww
