wwwwwwwwwwwww
w.11.1....+.w
w1.3w12.wwwww
w.w.1212w...w
w21.ww..2g2.w
w1.1...3..3ww
w.1.w.12.w23w
w22w..3.A...w
wwwwwwwwwwwww
