wwwwwwwwwwwww
ww.w.23..ww.w
w+.2..3w.2..w
w.ww1.1....ww
www2...1..www
w2..www2.g..w
www.w1.w.w.Aw
ww2.www.ww.ww
wwwwwwwwwwwww
