wwwwwwwwwwwww
ww.2.2w3..g1w
w.3w3.w2...ww
ww.w.w312.w.w
ww..www.w11ww
w..12.w331.2w
w.w1.w.3A.+ww
w...11.w.w.ww
wwwwwwwwwwwww
