wwwwwwwwwwwww
w3...3...w..w
w+311wwww1..w
w...w.w1....w
ww..g32..w3Aw
w.2w.w1w.ww.w
ww3.2..w2...w
w.3..1...1..w
wwwwwwwwwwwww
