wwwwwwwwwwwww
w.3...w..w.3w
w.2...w.2A.1w
w....1.....1w
ww..w..w233ww
w.+3..2.w3..w
w...w.2g.3..w
w...1.w.....w
wwwwwwwwwwwww
