wwwwwwwwwwwww
w...21.2.1.ww
w..+..1.31w2w
w.2w1..23Awww
www.w.212.3.w
w1.33....w.ww
w.3.1wg3....w
w2.2w..2....w
wwwwwwwwwwwww
