wwwwwwwwwwwww
w.1.3ww1.w22w
w.1...w+.11ww
w3.2w2A.....w
w....2...1www
www.1..w...1w
w.w1w..ww2.1w
w22w..w.3g..w
wwwwwwwwwwwww
