wwwwwwwwwwwww
ww..w3...w.ww
wwww1.w.1w..w
ww2..ww+.w.ww
www.w.w.3ww3w
ww...wg...w.w
www.ww..w..ww
wA11w2w..w1ww
wwwwwwwwwwwww
