wwwwwwwwwwwww
ww3w1w.233..w
w.wwww23wwwww
w3.1w111.+w.w
w111.33w.1A1w
w.1..1ww1w.ww
w2w21w..w1g2w
w.ww.ww.ww1ww
wwwwwwwwwwwww
