wwwwwwwwwwwww
w....3....3.w
w..3.g2+.3..w
w.311.1.3..3w
w.2....2.12.w
wA..1.....13w
w......2....w
w.......1211w
wwwwwwwwwwwww
