wwwwwwwwwwwww
w.A.......3.w
w2.....3.21.w
w.3..3..1...w
w2....3.g3..w
w+..32...31.w
w3....1...2ww
w1..311....2w
wwwwwwwwwwwww
