wwwwwwwwwwwww
w..3.33....1w
w....1...11.w
w..3.2..2..3w
w.2.g32.1...w
w3.31..A.1.+w
w..21..3.2.3w
w1...3...33.w
wwwwwwwwwwwww
