wwwwwwwwwwwww
w.w...2ww3.3w
w+212w3w.ww.w
ww.2211..w.2w
w2w.2.w11.3.w
ww1.A.3.21w.w
w.w..wg.31.ww
ww..1.2www.ww
wwwwwwwwwwwww
