wwwwwwwwwwwww
w3w323.w23.ww
w1..23...2w.w
w.23.312.w23w
wg.3.1w.1..ww
w1.3.322w.2.w
w+1.2.w.w1.ww
ww.ww.w3A3.2w
wwwwwwwwwwwww
