wwwwwwwwwwwww
w.w3223ww...w
w..w..2.w...w
w.w1A.1ww1w.w
w.w......2.gw
w.12w2w..w..w
w..ww.w...www
www.3.3w+1.ww
wwwwwwwwwwwww
