wwwwwwwwwwwww
ww221w1g.w..w
w.3w3.w2w2.ww
w2Aw23.2+2.2w
ww3w3..32232w
w3w..w3w.12.w
w.w1..3.1.21w
w..3..ww.w11w
wwwwwwwwwwwww
