wwwwwwwwwwwww
w..13w.2.wwww
w1ww1ww2w.g.w
w.w2.www+w11w
w3.1wAww.1..w
w.32w.3w..w.w
w231ww1.2w.1w
ww.w1.1ww1..w
wwwwwwwwwwwww
