wwwwwwwwwwwww
w2.+..2w3.w.w
ww...1w.wwwww
wA.21ww.....w
wg2...w..1..w
w.2ww3..w3w.w
w.3w2w.w.2..w
w.12.w2.w3.ww
wwwwwwwwwwwww
