wwwwwwwwwwwww
w.w3..w....1w
w+Aw132w1.3.w
w3..3.2..12.w
w1.33..1.w.ww
wwww33...3..w
w...w13.w..2w
w12w.g......w
wwwwwwwwwwwww
