wwwwwwwwwwwww
w1..w2..2...w
w..w.2......w
w..........ww
ww..w.w.w2.ww
w.....+.2g.ww
w..w.www..w.w
w.....w...A.w
wwwwwwwwwwwww
