wwwwwwwwwwwww
w..w.+...ww.w
w.ww3...w...w
w......w3...w
w.www1...w.ww
ww..w...w..ww
w1.3....w.www
w...wgw....Aw
wwwwwwwwwwwww
