wwwwwwwwwwwww
w32....11..1w
w31w....w1w.w
w..+..11w.3.w
w.2...3..23.w
w1w....233w.w
wA.3..3...11w
wg..3...1.www
wwwwwwwwwwwww
