wwwwwwwwwwwww
www.w2......w
w....3.wwww.w
w1..w..w...gw
w..+...w.33ww
w.ww3....3w1w
w.w.3.w..ww.w
w.w3wwA.3ww3w
wwwwwwwwwwwww
