wwwwwwwwwwwww
w.3..3.A3...w
w1...+.2..2.w
w2..2......gw
w.....33..33w
w2..........w
w......2...1w
w2....3.2...w
wwwwwwwwwwwww
