wwwwwwwwwwwww
w.3....w...ww
ww.w3w2..wwww
w.www3g.3..+w
w..1...1A..ww
ww1.w1.1w3www
ww3w..w.w..ww
w.ww.w.w.ww.w
wwwwwwwwwwwww
