wwwwwwwwwwwww
w211...wAw..w
w33w111.....w
wgww..31www2w
ww3.313...w3w
w321ww122...w
w3ww12www1+.w
ww2ww.3232w3w
wwwwwwwwwwwww
