wwwwwwwwwwwww
w...ww.www.2w
w..ww.www3www
w..+www..Awww
w2w..3..w3www
www.wg2ww2w.w
w.wwwww.w3www
ww.w..2...www
wwwwwwwwwwwww
