wwwwwwwwwwwww
ww2w.w.3.wA3w
ww.g.32.ww.2w
w12.2..w.3+.w
www...w33w1ww
w.w.w22..1.ww
www..1ww.w32w
w21w..www11ww
wwwwwwwwwwwww
