wwwwwwwwwwwww
w..g.w.3w32ww
w3w.3.wwww.ww
www2...w..www
www...3w..3.w
w+ww3w..w..2w
w1A..1ww1w2.w
w3w3w.w.3.1.w
wwwwwwwwwwwww
