wwwwwwwwwwwww
www1.2.A.w2ww
w.ww1w.wwww.w
w.w1w.3ww...w
www....w.w.ww
wg1w3w..1wwww
w2+..2w.3...w
ww21ww..w..ww
wwwwwwwwwwwww
