wwwwwwwwwwwww
w.......ww..w
w.A...2..2.ww
w....3w.1...w
w......w....w
w..2.w...2..w
w..w....31w.w
w.w+g...w...w
wwwwwwwwwwwww
