wwwwwwwwwwwww
ww......w...w
w....w.g....w
w.w.....Aw..w
w.....+.....w
w......w....w
w.w...ww....w
w...2.1....ww
wwwwwwwwwwwww
