wwwwwwwwwwwww
w...........w
w...........w
w...........w
w.......3...w
w...........w
w.g.....A.3.w
w.....+.....w
wwwwwwwwwwwww
