wwwwwwwwwwwww
wwA..32...23w
w131.1w2....w
w1.2.32.223.w
w..+.21.g2.1w
w....3.w..3.w
ww12.1.32...w
ww13.31.3.w3w
wwwwwwwwwwwww
