wwwwwwwwwwwww
ww.3ww...33.w
w1.111.2w3w.w
w.13....1...w
w.w1w..3..A.w
w.31.1ww.12.w
wg....w...3.w
w3..21.32+2ww
wwwwwwwwwwwww
