wwwwwwwwwwwww
w1..2.......w
w....w.w.w..w
ww..ww.1.32.w
w+.w.23.wA.3w
ww.w......w.w
www.....ww2.w
w...gw.2...ww
wwwwwwwwwwwww
