wwwwwwwwwwwww
w11w221w2Aw.w
w2..w..+3.2.w
w..w.w...w22w
ww1w2w231w2ww
ww22w.w21w32w
w232w3131g.ww
w..2...1..w3w
wwwwwwwwwwwww
