wwwwwwwwwwwww
w.3ww3..w.w.w
w..3w.2w.31ww
w.2..w1..22.w
www..wgw.13.w
w1...2.w1A2.w
w3.w1..1.1.ww
w.23.2+.3.22w
wwwwwwwwwwwww
