wwwwwwwwwwwww
w...2w..23w.w
w....3.23..3w
ww3..33.w.3.w
w.....32.2.1w
w.1...w..g.2w
w.2...ww..w.w
w.w..+.A..3ww
wwwwwwwwwwwww
