wwwwwwwwwwwww
w..www1....2w
ww2w....w.w.w
ww..w.w..w.+w
ww...2....2.w
w..A.www2.2ww
ww.w..w.2...w
w.w.gw..1.w.w
wwwwwwwwwwwww
