wwwwwwwwwwwww
w.w3w.w2w..3w
ww..221212www
w.w.w31w21.2w
ww1.1.g3Awwww
ww.w.11w.w+3w
w..21w.22...w
ww.2.1..w.www
wwwwwwwwwwwww
