wwwwwwwwwwwww
w..+.....3..w
w..3......2gw
w.....1.....w
w...2.......w
w.A.....3...w
w..1........w
w..2........w
wwwwwwwwwwwww
