wwwwwwwwwwwww
w1w..w.w.w..w
w1g12.......w
w...2.w.w.1.w
w.......w1..w
w...w.w.....w
w.www.....www
w.A.w+......w
wwwwwwwwwwwww
