wwwwwwwwwwwww
w........2..w
w1...3...2.Aw
w31.........w
w3...w.33.+.w
w.2......g3.w
w1........2ww
w...2.......w
wwwwwwwwwwwww
