wwwwwwwwwwwww
w1..2.3.2w13w
w.w3133.w.w.w
w....w.w.2.+w
ww.w.......ww
w1g.3.w3w..3w
w233w2w.ww2.w
w1.1w.A.ww.ww
wwwwwwwwwwwww
