wwwwwwwwwwwww
ww.1...A1333w
w3w3w.3..2.ww
w.3.......w.w
w.1..12..+.1w
w1g..331.13.w
w.w......2.3w
ww.....2w...w
wwwwwwwwwwwww
