wwwwwwwwwwwww
w.3....3..32w
w3.33...2+..w
w..3........w
w12..3......w
w.2..3.3g.3ww
ww....32..A.w
w3...3......w
wwwwwwwwwwwww
