wwwwwwwwwwwww
wwg.w3...ww1w
w.w.ww+w2ww.w
ww..1A..2wwww
w...w.w1w..ww
w3..w1.w.32.w
ww..w.w...2.w
w3w3w1w.ww.ww
wwwwwwwwwwwww
