wwwwwwwwwwwww
w..2.....3..w
w.gw..3.A2..w
w.+w..122...w
ww2.......3.w
w.w.3...ww..w
w..2..w..w.2w
w.w..1w.....w
wwwwwwwwwwwww
