wwwwwwwwwwwww
w22w3....+w2w
w....A2.w1.ww
w.2....22gw.w
w.3..31w1..ww
w2w2......2.w
w1w..1..2w2ww
w.2...w.w.2ww
wwwwwwwwwwwww
