wwwwwwwwwwwww
w......2...2w
w..w.+2wg1.3w
w.2.wwww2.w.w
w.1w.3.....2w
w1..w.ww....w
ww.w.12.w2..w
w.13w....1wAw
wwwwwwwwwwwww
