wwwwwwwwwwwww
ww.2.3w..A.ww
w.....w....ww
w..w...www.ww
w..www.g2.1ww
w2...wwww.+ww
w..w.www3..ww
w.w.3.......w
wwwwwwwwwwwww
