wwwwwwwwwwwww
ww...12..3.1w
w...3..3....w
w.w.31.3..2.w
w.+.1...1...w
w.g....2..A.w
w......w....w
w.......211.w
wwwwwwwwwwwww
