wwwwwwwwwwwww
w.w2.......3w
w..w..2...2.w
w.1w1ww.w1..w
w.w.w..w...1w
w.........w.w
w.wAw...g.1.w
ww.w.w.+....w
wwwwwwwwwwwww
