wwwwwwwwwwwww
w.w3w3....www
wg..wwA21...w
w3.2...1.w2ww
ww1.w..13w..w
w.....+2..w2w
ww3w.w.w.w2.w
w22112w.12.ww
wwwwwwwwwwwww
