wwwwwwwwwwwww
w1...211.w2.w
w+.w..3w.w2.w
w.12w.2....2w
w.w3.3.1..2ww
wg....33.2..w
w1w.322..2.Aw
w1w3..1.1w..w
wwwwwwwwwwwww
