wwwwwwwwwwwww
w.2.w2...2www
w.ww3.+.w3..w
w...w1w.A2..w
ww1w..1..333w
w2w3w.w.w2..w
w.ww3..1.w..w
wg1..w....21w
wwwwwwwwwwwww
