wwwwwwwwwwwww
wwwww3.3w..ww
w3.wwww.Aww2w
ww3..www1ww2w
w11....333.2w
ww.31.31...gw
ww...+.3.33ww
w.w13w3ww3www
wwwwwwwwwwwww
