wwwwwwwwwwwww
w....w......w
w...w.......w
w........g.ww
w.A.........w
w...........w
w.w.....w.+.w
w....w...w..w
wwwwwwwwwwwww
