wwwwwwwwwwwww
w..3112...3.w
w+...3..21w1w
w3.w...2...2w
w..w1...gw..w
w1wA..3w..1.w
w..w.....1..w
w..213..w3www
wwwwwwwwwwwww
