wwwwwwwwwwwww
w..w..ww....w
ww2..12+w.www
w21.w11.1...w
w3.wwww.w1w1w
w...12w3..www
w1..w..w.12.w
w.3A2w.w13.gw
wwwwwwwwwwwww
