wwwwwwwwwwwww
wwww...22ww2w
w.ww3w3.3.11w
w.22..2w1.w.w
www..ww3..w+w
w..wA.w..ww.w
w3ww.w21ww.1w
w1...121w31gw
wwwwwwwwwwwww
