wwwwwwwwwwwww
www..1...2w.w
w3...3.ww3.ww
w1..3.ww...3w
w..2.1..33.1w
w....+.2.g.ww
w1.313...2Aww
w.w.....323.w
wwwwwwwwwwwww
