wwwwwwwwwwwww
ww2ww2..w.33w
w..Aw12g31www
w1..3w..2ww3w
w313...w.w31w
w2ww131.w3.3w
ww.w3..w3112w
ww.w+2.333..w
wwwwwwwwwwwww
