wwwwwwwwwwwww
w.2.1..12...w
w.....2.22.1w
w3+...32.2.2w
w121...2..31w
w3g.1.2.A...w
w232.313.2.2w
w3.3..1.1.21w
wwwwwwwwwwwww
