wwwwwwwwwwwww
w.w3w31.w31ww
w.wwwwwww.www
www1w2.ww22.w
wwww2w1ww.w.w
w+.A.2w.w3www
w..3..w3.g1ww
w.2.1...ww.3w
wwwwwwwwwwwww
