wwwwwwwwwwwww
w...+w..w...w
w2..w.www2..w
w.w...g.....w
www....www..w
ww.........3w
ww.w.A.ww...w
w..ww....wwww
wwwwwwwwwwwww
