wwwwwwwwwwwww
ww.3.A2.....w
w.1..2.2.1.2w
w......3w.+1w
w1w......1g1w
w.2..1w..w31w
w.ww..ww...2w
ww.....1.w..w
wwwwwwwwwwwww
