wwwwwwwwwwwww
w12g1w...w3ww
wAw23w3.222.w
w..+...2w2.1w
ww.2.1.3ww..w
w.2ww.311w.3w
ww.w3ww..3.3w
w213..3..12.w
wwwwwwwwwwwww
