wwwwwwwwwwwww
w...w.......w
w......w...2w
w.2..g......w
w..12..1....w
w23..2......w
w...2..w.32+w
ww1....A....w
wwwwwwwwwwwww
