wwwwwwwwwwwww
w....ww...w.w
ww..3.w....ww
ww1Aw......ww
w...ww..g3www
w.w..w...3w1w
w.....w.ww..w
w.11.w....+.w
wwwwwwwwwwwww
