wwwwwwwwwwwww
ww.gAw......w
w..w.3.w....w
www+..w..w3.w
w1.........2w
w..w1.2.....w
w...........w
w......w....w
wwwwwwwwwwwww
