wwwwwwwwwwwww
w.1..3w121+.w
w2..2.3w1.33w
w.3.3w31..22w
w.333211...3w
w12.31.w1ww.w
w3g1.ww1.1w3w
w1...3..2A.ww
wwwwwwwwwwwww
