wwwwwwwwwwwww
w.3..3...32ww
w1..1w+22.2.w
w.3.2..22.13w
w.2131.1...3w
w3.111..3.1ww
w1212121.2.1w
wg..w....A.2w
wwwwwwwwwwwww
