wwwwwwwwwwwww
ww12www+3.w.w
w..w2.11w.w1w
w13wg22w3..ww
ww3w..1w31.ww
w.w2..w...w.w
w2ww..Aw.w1ww
w3..3..1.3www
wwwwwwwwwwwww
