wwwwwwwwwwwww
w.w1www1.w.3w
w.2ww+A3www.w
www2.ww..ww2w
ww1w2.ww.ww1w
w1www2w.1gwww
ww.wwwwww.www
ww32www2w231w
wwwwwwwwwwwww
