wwwwwwwwwwwww
w.32w.12+w2.w
w.A..w22www2w
ww32.w.1..1.w
ww23ww31....w
ww..2...ww.ww
ww2.3gw3313.w
w.1.21.w..3ww
wwwwwwwwwwwww
