wwwwwwwwwwwww
w..ww.......w
w.wwwwwA.w3ww
ww..2...w.3.w
w....132.2..w
w..w.3w.www.w
w+..w212gw1.w
wwww.w...1..w
wwwwwwwwwwwww
