wwwwwwwwwwwww
w...........w
w3.....2.1.1w
w11.g....1..w
w1.2...3....w
w.3.....2...w
w...+.13.12.w
w3..A3...2..w
wwwwwwwwwwwww
