wwwwwwwwwwwww
w..w2ww.w..ww
w.w121w..wwww
ww..1ww..2.ww
w2.w.....1.ww
w13.1.2.Aw2.w
w......g.w+.w
ww3.www...w.w
wwwwwwwwwwwww
