wwwwwwwwwwwww
w..2.w.....ww
w.w3..w..33.w
w3...w2.w..ww
w..w.......ww
w.1...+.Aww.w
w...w..g.1w.w
w....w3.....w
wwwwwwwwwwwww
