wwwwwwwwwwwww
w3w3wwww22..w
w.112ww1w.2.w
wwwwww.ww1.ww
w..w.g3....ww
w2.w..w3w..2w
w.+.3w1.3A13w
ww.ww31.23www
wwwwwwwwwwwww
