wwwwwwwwwwwww
wwwww..3w1w.w
w22w.www.w..w
ww..w2..2ww3w
wA.3w31..2www
w3ww12w.22.ww
w.w...ww2g3.w
w31.23ww+..2w
wwwwwwwwwwwww
