wwwwwwwwwwwww
w..w.1....w.w
w.w.w...wg..w
w..w.ww..w..w
w...w.A..2..w
w....w...+w.w
w.w....w1...w
w...........w
wwwwwwwwwwwww
