wwwwwwwwwwwww
w2...2A..w..w
w1...w....3.w
w.21.w.1w.1.w
w1.w...11..ww
ww..33...3..w
www.+..ww2w1w
w.g..w...w.3w
wwwwwwwwwwwww
