wwwwwwwwwwwww
w.w..w+11313w
w1.ww.31gw1.w
www.w2......w
ww33...3w...w
www.w.2...www
w..11.wA..w.w
ww1.ww.w1w..w
wwwwwwwwwwwww
