wwwwwwwwwwwww
w...w..w.ww.w
w.12.w1..2w3w
ww.g..+.w23ww
w.3w.ww.w.A2w
ww.3w.1w1..3w
w2....2w..21w
ww321.22.1..w
wwwwwwwwwwwww
