wwwwwwwwwwwww
w..........ww
w2...A.....2w
w.....w.g.33w
w...........w
w.....2....ww
w+3.........w
w.....1....2w
wwwwwwwwwwwww
