wwwwwwwwwwwww
w...w2..g+..w
w.........3.w
w....A.....1w
w......w..2.w
w2...w......w
w....w.12..3w
w.....2.w.1.w
wwwwwwwwwwwww
