wwwwwwwwwwwww
ww.w.A1.1...w
w.g.3...w...w
www.3.www...w
wwww.w+w.w..w
w.ww...www1.w
w......w...ww
w.w..w.ww..ww
wwwwwwwwwwwww
