wwwwwwwwwwwww
w.+.1.22....w
w...........w
w..13w..31..w
w2.....331..w
w....A..3...w
wg.....2w...w
w2.1.1......w
wwwwwwwwwwwww
