wwwwwwwwwwwww
w1...w31.w2.w
w.w.1....w..w
w11w1..3ww..w
w.ww...+.w.ww
w1.w..w...1ww
w.1..w1w1w2.w
w.w..g2.wA..w
wwwwwwwwwwwww
