wwwwwwwwwwwww
w.11221..w1.w
ww.2...w+w12w
w12w.3..A1w.w
ww2.www12.w2w
wwww3w1w...ww
ww1g.w1w..www
ww.w...13.22w
wwwwwwwwwwwww
