wwwwwwwwwwwww
w......w..w.w
w.....1..3.3w
w.3.A.....+.w
w2g....w....w
w........1..w
w........2..w
w.w.3.1.1..3w
wwwwwwwwwwwww
