wwwwwwwwwwwww
w.w....w2.3+w
w21.2ww.w...w
w.w..3..g..ww
w1w.ww.www.ww
ww.1ww.....ww
w.....w1....w
w...w..1w.Aww
wwwwwwwwwwwww
