wwwwwwwwwwwww
w.1w.1..2w.2w
w....2w..w.ww
w2.w..211w..w
w......1A.2+w
w.2.wgw...1ww
w.2..ww.w3..w
w3.3..13w1..w
wwwwwwwwwwwww
