wwwwwwwwwwwww
w....2...2..w
w....3......w
w..w.A.w.2w2w
w..w...ww.w3w
wwgw3www.+..w
w3www1..w..ww
wwwww2.ww.2.w
wwwwwwwwwwwww
