wwwwwwwwwwwww
w1ww2w2.ww13w
ww.w232wwww3w
ww1ww1www1..w
w+wg.www2.3.w
w.wA.2www12ww
w...w.ww.3www
www3w3131w12w
wwwwwwwwwwwww
