wwwwwwwwwwwww
w2w.1222..1.w
w3.....3..3.w
w.....+11321w
w..g..332..1w
ww3.3..A1.13w
w....131..w1w
w.......w.1.w
wwwwwwwwwwwww
