wwwwwwwwwwwww
w33w.1.13.11w
www+.wwwwww3w
wg.Aw1www2www
ww.3.w..w3w2w
www.3ww1.w13w
w.w..wwwwwwww
www.www3..w.w
wwwwwwwwwwwww
