wwwwwwwwwwwww
w..1......21w
w...1..2.ww.w
w.w...g.+2..w
w......31..3w
w...w311.A..w
w.w2.....1..w
w.w.2....1..w
wwwwwwwwwwwww
