wwwwwwwwwwwww
w..2..13.1..w
w.21....1.+1w
w...1w...2.Aw
w.3..2.2..2.w
w.....w....2w
w1..1g..w...w
w...1...w2w1w
wwwwwwwwwwwww
