wwwwwwwwwwwww
w.2.w.2...2.w
w3..w....2..w
w3w3..w....ww
w2.+..1.3w.ww
w..w2....2w.w
w..........ww
w....g....A.w
wwwwwwwwwwwww
