wwwwwwwwwwwww
w.3A....w.1.w
w.wwww3www+3w
w.1...3.ww..w
ww.w.1...w..w
w.w.w..2..2.w
w2....3.32..w
w.g.2w...3.2w
wwwwwwwwwwwww
