wwwwwwwwwwwww
w...3......1w
ww...w......w
w...23......w
w..........1w
w..3..w..1..w
w.g.13A.w...w
w...+3......w
wwwwwwwwwwwww
