wwwwwwwwwwwww
www.w.w3.+.1w
www..wwwAw.ww
ww..w.ww...ww
www...ww..w.w
w....w1wg.w.w
w2.www..w1w.w
w3w32..ww..ww
wwwwwwwwwwwww
