wwwwwwwwwwwww
w3w1.w2...2.w
w......3+.1.w
w..1w...3132w
ww1...w.1...w
w.2.2...w2..w
w...A...1w.gw
ww.w.w3.2.w.w
wwwwwwwwwwwww
