wwwwwwwwwwwww
w3w3..3...3.w
w....w.3+.3.w
w..2....3231w
w.g...w.1w..w
w.2.1....2..w
ww..A...1..3w
ww...13...w.w
wwwwwwwwwwwww
