wwwwwwwwwwwww
w.1..3.+....w
w3..w.wwww.ww
w..w.3ww...ww
w..221w..1Aww
ww..wwwww.1.w
w...gw..w.w.w
w.w....w..www
wwwwwwwwwwwww
