wwwwwwwwwwwww
wg31w.w2.3.2w
w...w...3w.1w
w..ww.1ww.www
w13...w..w2.w
ww...1....23w
w2ww.ww.wwwAw
ww3.3....+.ww
wwwwwwwwwwwww
