wwwwwwwwwwwww
ww.....w.w..w
w.3....w.gw.w
w....w+..2..w
w...........w
w1w..3w.A...w
w1.2..13...ww
w...w32....2w
wwwwwwwwwwwww
