wwwwwwwwwwwww
w......+....w
w......wAw2.w
w...w.......w
w...........w
ww.....g....w
ww..........w
w.w.w.3w....w
wwwwwwwwwwwww
