wwwwwwwwwwwww
w.1.3.3121..w
w.1w.231.332w
w...w3122.2ww
w1...2...3..w
w.1.313.2gw3w
w23w.2+11A3ww
w31133.2.3w.w
wwwwwwwwwwwww
