wwwwwwwwwwwww
w.w3w....1.2w
w1....1w11..w
w1.1w12w3+..w
w..2.w..1.23w
w11.2....321w
w2www1.w.3.Aw
w2.g.311w32.w
wwwwwwwwwwwww
