wwwwwwwwwwwww
w.2.w.w...2.w
w1.+...Aww..w
w3w..ww.w...w
w.w.....w...w
w....w3.w.w.w
w...323...w.w
ww.w.g.w.w32w
wwwwwwwwwwwww
