wwwwwwwwwwwww
w2.w.....ww.w
ww.w...11...w
w..ww.1.....w
w.2.1+.2..w.w
w13.....3.3.w
w2..3.w.1g3ww
w2w.3.232A.1w
wwwwwwwwwwwww
