wwwwwwwwwwwww
w......w2.31w
w1ww+.2..w.1w
w.3...3w..w.w
www..g..ww3.w
ww3.w.w..w..w
wwAw3ww..w..w
w2w.21...wwww
wwwwwwwwwwwww
