wwwwwwwwwwwww
w1.w.A.132..w
w2ww2w2w....w
w.3..2.1g21ww
w1.w1.2.+1.2w
w.w.1.2..w33w
w.3w..3.21..w
www3.3w33w..w
wwwwwwwwwwwww
