wwwwwwwwwwwww
w123.....g.3w
w2..22w..+.2w
w.2.232ww3..w
w3.2.Aw.2ww3w
ww.ww.13.w..w
w2121w3w..2ww
w12..1.21213w
wwwwwwwwwwwww
