wwwwwwwwwwwww
w31......3.1w
ww.wgww..1.Aw
w.1.w13ww.1.w
w1.323w.2ww+w
ww.ww.22.ww.w
ww2w.32www2ww
ww3.ww.23w12w
wwwwwwwwwwwww
