wwwwwwwwwwwww
w.....1w.g..w
w1..1.3A+1..w
w3.2....2...w
w.2w.133.1..w
w...2.1131..w
w21.32...2..w
w...1..12.w.w
wwwwwwwwwwwww
