wwwwwwwwwwwww
w....w..w...w
w....ww.w.w+w
w.........A.w
ww......w...w
w.w.....w..ww
wwwg......1.w
w.....w.w...w
wwwwwwwwwwwww
