wwwwwwwwwwwww
w23...w.....w
w1.....+...2w
w.......w..gw
w.......w...w
w33.2Aw...w3w
wwww1.3..2..w
w.w.2.w.....w
wwwwwwwwwwwww
