wwwwwwwwwwwww
w..1gww.w312w
w3ww.1.w.1.2w
w.ww..w3w2.ww
w..2w.w313w.w
w3w2..312...w
w2.+...1.31.w
w21wwA....1.w
wwwwwwwwwwwww
