wwwwwwwwwwwww
w1.3...2.11.w
ww...3.3w..3w
w2..1.23.g..w
w.A..13..3.2w
w..1..3...1.w
w2....1.....w
w2.3..3+....w
wwwwwwwwwwwww
