wwwwwwwwwwwww
w1..31....w1w
w2.331.31w13w
w2.+2w2..3A.w
w.....332...w
w2.1..313331w
ww1..2.1w.1.w
w3.32g..3.3.w
wwwwwwwwwwwww
