wwwwwwwwwwwww
ww13w33w.ww1w
w.....1..3..w
w.2....w..1.w
w.w..1....1.w
w3w3+wwA..w.w
w.2.2..w..2ww
w2.w.gw1wwwww
wwwwwwwwwwwww
