wwwwwwwwwwwww
w.........www
ww.1.w31w1.+w
w3w.1w3.1g2.w
w13w..wwww..w
w.w.3w32w.13w
w..2ww31.w11w
ww31Awwww.2.w
wwwwwwwwwwwww
