wwwwwwwwwwwww
w.........w.w
w1.w.w.ww2.gw
ww.w.1..www.w
w1ww.ww+wwwww
w.1...w.w.23w
ww.w2w.3.w.2w
w231Aww3w.1.w
wwwwwwwwwwwww
