wwwwwwwwwwwww
w..32w2331www
w3w2.+.3..w1w
w1.2www.w2..w
w1.31.2.w11ww
w...21g.w21ww
w333wA3w...2w
www31.3ww.3ww
wwwwwwwwwwwww
