wwwwwwwwwwwww
w.3w3..12.1.w
w3...1w3.w11w
w..12.ww1w2ww
wwA231w2w...w
wgw.w1w3..2+w
w1...2w1.w.ww
ww1..ww.www.w
wwwwwwwwwwwww
