wwwwwwwwwwwww
w......2....w
w3w11...2...w
w3.....w....w
w.3w........w
w3.w3w.A.w..w
w..3.3.3.+..w
w.21w....g..w
wwwwwwwwwwwww
