wwwwwwwwwwwww
w..w..ww..www
w.3.g..+.32.w
w.ww1.1.....w
w31w1......ww
w..ww.2...1.w
w.A1w....2..w
w3.w2.2.ww3ww
wwwwwwwwwwwww
