wwwwwwwwwwwww
wA.......w..w
w...........w
w...w.......w
w.ww..gw..www
w.....w..+..w
w.w....ww...w
w....ww...31w
wwwwwwwwwwwww
