wwwwwwwwwwwww
ww3.wwwww1.3w
ww2.32w1www.w
www11..w313ww
ww313w1wg.www
www1w2w.wAwww
w.+.3.1...1ww
ww213.2w.w33w
wwwwwwwwwwwww
