wwwwwwwwwwwww
w..ww....3..w
ww.....www..w
w11w.+1.w.www
ww...1.w22..w
w.ww...w.w3ww
w21.A..w....w
ww.ww.g..1.3w
wwwwwwwwwwwww
