wwwwwwwwwwwww
w2.w..11w...w
ww.....gA.w3w
w..w+...3.2.w
w....w.w...ww
w.ww...3.2..w
w...........w
w...w.w.w.www
wwwwwwwwwwwww
