wwwwwwwwwwwww
w.....3....1w
w3....1.....w
w1+...3.g...w
w.A..1...1..w
w.3.....1...w
w....1......w
w...1.......w
wwwwwwwwwwwww
