wwwwwwwwwwwww
wwg2w.w31ww.w
w.w+A.ww3..2w
wwww.3.w.ww.w
w..w2wwww.www
w.w3..ww..www
w3w...w..w..w
www.3w...ww.w
wwwwwwwwwwwww
