wwwwwwwwwwwww
w3..2.1..3+2w
w3...3.22..ww
w....333..2.w
w3.w...1.3.1w
w.1...g...33w
w.1.2.2.1.A1w
w....1.1.3.3w
wwwwwwwwwwwww
