wwwwwwwwwwwww
w.3w.w.w.wwww
w31...w3.ww.w
w3w233.1www.w
w3w.33..w12.w
ww1w1gww1..+w
ww12w.2w.33ww
ww2.w11A1w1.w
wwwwwwwwwwwww
