wwwwwwwwwwwww
w.w..w3w..w3w
w+...www.1..w
w.ww.w...1.ww
w....w...gA.w
ww..ww..w11.w
w...w..w.w..w
w.....w...1ww
wwwwwwwwwwwww
