wwwwwwwwwwwww
w.1.3233.3.1w
w....22..3..w
w....2.2...2w
w.1.3.32.11.w
w.+11..112..w
w3.31.A1....w
w1g..2..3.1.w
wwwwwwwwwwwww
