wwwwwwwwwwwww
wwww3www2wwww
www3ww1w32www
w.23w3w.Aw12w
www3...w.w..w
w1w.w3w.33w1w
www3ww2w.+g.w
www333.wwww2w
wwwwwwwwwwwww
