wwwwwwwwwwwww
w11.....w3g.w
ww.311wwwA..w
w.w123+2w23.w
w.w.11.w2.w.w
w3....312w2.w
w2w2w1.w...3w
w2w.1w1.w2..w
wwwwwwwwwwwww
