wwwwwwwwwwwww
w.........1.w
w.31..3..3.3w
w...3w......w
w22.w1......w
w.3.33.....gw
w3.2..w+....w
w...A..23...w
wwwwwwwwwwwww
