wwwwwwwwwwwww
ww...+w..w.3w
w....A...w..w
w.ww3.ww22..w
w.......1w..w
w..w.1......w
w.g..1w2...ww
w.3w..2..w..w
wwwwwwwwwwwww
