wwwwwwwwwwwww
w.1.23ww..+.w
w.wwgw11.1w3w
w1w3.2.212.2w
w3..31ww.3w1w
ww.w.1Aw.22ww
ww.w12w.w..ww
w..w31..11.1w
wwwwwwwwwwwww
