wwwwwwwwwwwww
w.231.w....1w
ww....3..w..w
w.....3w.3.2w
w...1.21w+g.w
w.A.........w
w2..3.2....1w
w.......1...w
wwwwwwwwwwwww
