wwwwwwwwwwwww
w..131w3...Aw
w23.w..1.3..w
w.....13..2.w
w..3.....+2.w
w....2..3.21w
w.1...ww3.2.w
w....w.....gw
wwwwwwwwwwwww
