wwwwwwwwwwwww
w.....3....1w
w22.1.......w
w.....31.w2.w
w.......33..w
w....A..g.21w
w.1...133.+2w
w..........3w
wwwwwwwwwwwww
