wwwwwwwwwwwww
w.....3.3233w
www1..w.w.www
w32.w.1ww...w
ww....1+....w
w.3A1.3.w.2gw
w.....2w..2.w
w.w.w...1..ww
wwwwwwwwwwwww
