wwwwwwwwwwwww
w...1w11w..Aw
ww3..3w1.w13w
ww3.3w..g1.ww
w2.w.w3ww...w
w+w2.w.....ww
w......w.w..w
ww..23w.2w..w
wwwwwwwwwwwww
