wwwwwwwwwwwww
w....w......w
w....3.w1.w1w
w.......A+..w
w...w331....w
w.....w.....w
w....gw3.2..w
w11....w...1w
wwwwwwwwwwwww
