wwwwwwwwwwwww
w.2.31......w
w..3.....A11w
w....11.3..3w
w..3..w...3.w
w+w.w.......w
www.w.12..3.w
w3.ww32g132.w
wwwwwwwwwwwww
