wwwwwwwwwwwww
w....ww.....w
w.2w......w.w
ww.332......w
w....2.gw...w
w...+.3w....w
wA..w3w..w..w
w....3.3w...w
wwwwwwwwwwwww
