wwwwwwwwwwwww
w..w..w.....w
w.....w..g.ww
w.....w.....w
w........wwww
w.w.........w
ww......wAw.w
w.+....w.w..w
wwwwwwwwwwwww
