wwwwwwwwwwwww
w......w..w.w
w.w......ww.w
w...ww..ww.ww
w+w.ww..wA..w
w.....3.w...w
w.w......g.ww
w...w....w..w
wwwwwwwwwwwww
