wwwwwwwwwwwww
w.......31www
w3.3.11.1+w.w
ww.3.....2..w
w1w.w.3...w.w
ww.A.g......w
w121w.......w
w..3w2.w...ww
wwwwwwwwwwwww
