wwwwwwwwwwwww
w....w2..2..w
w.ww.1.13...w
w...w.2.....w
ww...+.A1.3.w
w1.w.31.....w
w.........w.w
w.23..g.....w
wwwwwwwwwwwww
