wwwwwwwwwwwww
w...w.1.....w
www.g......1w
w.......w...w
w.1...+.w...w
w....w....w.w
w.2.......www
wA......w...w
wwwwwwwwwwwww
