wwwwwwwwwwwww
w.w..1......w
w.1...wg33..w
w3........3ww
w....A...w..w
w.3...3+...ww
w3..........w
w..1.....3.ww
wwwwwwwwwwwww
