wwwwwwwwwwwww
w1.w......Aww
ww.+........w
w...ww...1..w
w3.......1.gw
w.w.w.......w
w.....ww....w
w...........w
wwwwwwwwwwwww
