wwwwwwwwwwwww
w........A..w
w3...w......w
w..1..ww..w.w
w+w3.......1w
w....w......w
ww..w..g....w
w...2w....w.w
wwwwwwwwwwwww
