wwwwwwwwwwwww
w....1Ag....w
w.3..3..1...w
w.........www
w.2....w....w
w..32.+.....w
w3..1.2....2w
w2.3..ww....w
wwwwwwwwwwwww
