wwwwwwwwwwwww
w..1.3ww.w.2w
w..1w..13...w
ww....3....gw
w.1.1.....A.w
w.2..1......w
w.12.+2..w..w
w3.....22w..w
wwwwwwwwwwwww
