wwwwwwwwwwwww
w.w.+.......w
w..3...2....w
w.........w.w
w....w.w....w
w.w.w......ww
w1.A..w..wg.w
w.3.w.....w.w
wwwwwwwwwwwww
