wwwwwwwwwwwww
w..........Aw
ww....g.w...w
ww.w....w...w
ww..w.......w
w........+..w
w.....w.....w
w.........w.w
wwwwwwwwwwwww
