wwwwwwwwwwwww
w...ww..w..gw
w...........w
w........ww.w
w.w...w...w.w
ww.....A.w..w
w......w...+w
w...ww....w1w
wwwwwwwwwwwww
