wwwwwwwwwwwww
w.w..1.w....w
ww..w...+w..w
wg..3....w..w
w.....3....ww
w..w..w...Aww
w.ww.33.....w
ww.ww..w...ww
wwwwwwwwwwwww
