wwwwwwwwwwwww
w......w....w
w1..A......ww
ww.+g.......w
ww..........w
w.........w.w
w...........w
w...2.......w
wwwwwwwwwwwww
