wwwwwwwwwwwww
w3...wg.....w
w..w1..1....w
www....w+...w
w......1....w
w...........w
w...w....3..w
w..A..w..1..w
wwwwwwwwwwwww
