wwwwwwwwwwwww
w..3....3..ww
w....w.1w...w
w.......A1..w
w..ww.1.1...w
w.w......w.+w
w......w....w
wg..2......1w
wwwwwwwwwwwww
