wwwwwwwwwwwww
w..1..13...2w
wwwg....1..1w
w.+A..23..w.w
w2w..2......w
w1.......1w.w
w..21.w..1..w
ww..........w
wwwwwwwwwwwww
