wwwwwwwwwwwww
w.3...3.g...w
w..1.3..32.2w
w.13...A..2ww
ww..3.3.w..+w
w11........1w
w...3.2...1.w
w.2.....3...w
wwwwwwwwwwwww
