wwwwwwwwwwwww
w.....w..w..w
w.....w..2.ww
w.....1.....w
w..1.....gwww
w....2......w
w3......wAw.w
w.2......+..w
wwwwwwwwwwwww
