wwwwwwwwwwwww
w31.......+ww
w...1w..g.w.w
w..ww.......w
w..ww.2.....w
w.........1.w
w2w..Aw.2ww.w
w.w.........w
wwwwwwwwwwwww
