wwwwwwwwwwwww
w.1.w3...2w1w
w..g2.2.w2.1w
w...33..A2..w
w1+w..2..312w
w2w1w.w1w1.2w
wwww1..1.1..w
w1...w....23w
wwwwwwwwwwwww
