wwwwwwwwwwwww
w.w..1.g....w
ww..w...w...w
ww..A....w.2w
w...w.w..w.ww
w.....w.w.w.w
wwww..+.....w
ww.2w......ww
wwwwwwwwwwwww
