wwwwwwwwwwwww
w.gw.w3w3.w.w
w.+Aw31.....w
ww....2w.ww.w
w.w.........w
w.w...w.2...w
w..w.w.ww...w
w....w....www
wwwwwwwwwwwww
