wwwwwwwwwwwww
w..ww.2.1.w.w
ww.+g.w.w..ww
w.....w.w...w
w.......www.w
w..w.w......w
wAw.2.......w
w.....www..ww
wwwwwwwwwwwww
