wwwwwwwwwwwww
w.w.1....1..w
ww.A...2....w
w..3.......+w
w.....w..w..w
w.....w3.w..w
w...1.gw...ww
w..ww..3w..1w
wwwwwwwwwwwww
