wwwwwwwwwwwww
w.....+.....w
w.Ag.......2w
w...........w
w...........w
w........w3.w
w..1w..3...3w
w......1....w
wwwwwwwwwwwww
