wwwwwwwwwwwww
ww.23...2...w
w..w....1.A.w
w.....w.2w..w
ww.....w1.+.w
w1.13..w13..w
w.2....32g3ww
w3....1.31w.w
wwwwwwwwwwwww
