wwwwwwwwwwwww
wgww233...2.w
w..3........w
w.3.A.3.3...w
w3.3...www..w
w..1...ww2..w
w....w.....ww
w.2w3+w....ww
wwwwwwwwwwwww
