wwwwwwwwwwwww
w....A...2..w
w..........ww
w...........w
wg.+ww......w
w....ww...1.w
w...........w
w.......w...w
wwwwwwwwwwwww
