wwwwwwwwwwwww
w....2w+..1.w
w.3.wA......w
w.w...2..2w.w
w.3.2.......w
w.w..wg...1.w
w2.3....13w3w
w.......131.w
wwwwwwwwwwwww
