wwwwwwwwwwwww
w.w..3...w..w
w......1....w
wA..3...3.w.w
ww..........w
w...w.......w
w+.13..2w...w
wgw..w.3..w.w
wwwwwwwwwwwww
