wwwwwwwwwwwww
ww........w.w
w..w1.1.w..+w
w..3...w.3..w
w..wA.w..w.1w
w.3w.w1.....w
w1ww.w1w3w.gw
w.ww........w
wwwwwwwwwwwww
