wwwwwwwwwwwww
w.....w...A+w
w...gw......w
w....3....www
w...........w
ww.w......2ww
w....3...ww.w
w..ww.....w.w
wwwwwwwwwwwww
