wwwwwwwwwwwww
w......3.22.w
www11.3.22..w
w2.....w....w
w.1..2......w
w1w.13.2....w
w..2.2.1.A..w
wg+2.....3..w
wwwwwwwwwwwww
