wwwwwwwwwwwww
w....w3..w..w
wA..3....w.ww
ww..1.....w.w
w.w..1+w3.1.w
w......3.g..w
w.......w.w.w
w.1...3.....w
wwwwwwwwwwwww
