wwwwwwwwwwwww
w.....3.w..ww
w...........w
wwg.w...ww1ww
w.ww........w
w...........w
w....+..A.w.w
w...ww.w....w
wwwwwwwwwwwww
