wwwwwwwwwwwww
w.3.122.A...w
w2.......222w
w112.1......w
w.1.321...w.w
w+1.2.2.w2..w
w...1g.2.w.1w
w...2212.3.2w
wwwwwwwwwwwww
