wwwwwwwwwwwww
w...2......2w
w3...1..2..ww
w.g21w22w...w
w2.2...2w...w
w2+A11..2.11w
w..........2w
w.......1...w
wwwwwwwwwwwww
