wwwwwwwwwwwww
w..w1..w..A2w
w..2....3...w
w..w...w....w
w.2.3..12...w
ww...+...2..w
w..13.......w
w1g.....w.w.w
wwwwwwwwwwwww
