wwwwwwwwwwwww
w...+w21..22w
w...w..1....w
w..2...31.23w
w..ww.2.....w
w3A2..w...1.w
w......13..1w
w.3...3g...1w
wwwwwwwwwwwww
