wwwwwwwwwwwww
w...2.w.....w
w......1...ww
w...1w...1..w
w..3g..2....w
w13.33.....2w
w3..2....3+3w
w2.....A....w
wwwwwwwwwwwww
