wwwwwwwwwwwww
w2..w.w1..w.w
w.Aw.w....w.w
w.....g.2..ww
w2w..w.w..w.w
w....w.2...ww
w..w......1.w
w3w+.......ww
wwwwwwwwwwwww
