wwwwwwwwwwwww
w..1.......1w
w...3..g....w
w.3.........w
w.....A....ww
w..1...3.w.1w
w.....2+..3.w
w..2..w.....w
wwwwwwwwwwwww
