wwwwwwwwwwwww
w.........w.w
w........2..w
w.w...wA....w
w.....+.w...w
w..........gw
w...ww...w..w
w..........ww
wwwwwwwwwwwww
