wwwwwwwwwwwww
ww....w..1.ww
w2...2w....3w
ww..w..3....w
ww..w.g....ww
w...w..w.w..w
w1..1A3.w...w
w..+w...2w..w
wwwwwwwwwwwww
