wwwwwwwwwwwww
w1w.w.w.....w
w...........w
w...A.......w
ww...w..2...w
w1..wg......w
w3w.+...w..ww
w.w31.......w
wwwwwwwwwwwww
