wwwwwwwwwwwww
w..........ww
w...1w......w
w.........+.w
w...........w
w.......2..Aw
w...1.g...w3w
w.1....2....w
wwwwwwwwwwwww
