wwwwwwwwwwwww
w...w.2...w.w
w....A.3..w.w
w...2...2ww2w
w.+......3..w
w..w1.g.w...w
w3.1.ww....ww
w....1.3.1.ww
wwwwwwwwwwwww
