wwwwwwwwwwwww
w2....2...w.w
w.w.w.......w
w..w.....w..w
w..3.....33.w
wA.....w....w
w+........1.w
w.g.........w
wwwwwwwwwwwww
