wwwwwwwwwwwww
w...........w
ww....w..w.1w
w.3.2w...3..w
ww..w.......w
w...gw...w+.w
w......w22..w
w2....A.w..ww
wwwwwwwwwwwww
