wwwwwwwwwwwww
w.w.+w..ww.ww
wwww......w.w
w3..3w.....ww
w.3..3......w
w1....w...w.w
wwg.w..w....w
w.A.........w
wwwwwwwwwwwww
