wwwwwwwwwwwww
w..w....+..ww
ww.....1..3.w
wA.w..w....ww
w....ww....ww
w.wwg.....w.w
ww..ww.w....w
w....w1.....w
wwwwwwwwwwwww
