wwwwwwwwwwwww
w.....w....ww
w...........w
w.33..w..1wgw
w....A..w.w.w
w1.....3....w
w..w...+..w.w
ww...11.....w
wwwwwwwwwwwww
