wwwwwwwwwwwww
w32.2w+.....w
w..w...2....w
w...........w
w...3.3...w.w
w3.2........w
w.A.........w
w.g.3..3...3w
wwwwwwwwwwwww
