wwwwwwwwwwwww
w+........w.w
w..w.....3..w
w.........w.w
w.3ww.g.....w
ww.w...w....w
w.......wA.ww
w.3.........w
wwwwwwwwwwwww
