wwwwwwwwwwwww
w..1.1....w.w
w..2..1w....w
w...1w3...2.w
w31..2.32...w
w...w.+.w3..w
w....A.3.w.3w
w.2.g2......w
wwwwwwwwwwwww
