wwwwwwwwwwwww
w2ww.3w.....w
w..3.g.1....w
w.....1.....w
w........12.w
w...w...+.w.w
w.w..A...w..w
w.....2.....w
wwwwwwwwwwwww
