wwwwwwwwwwwww
www...w..w..w
w..w....1ww.w
w.w+w.w..1w.w
w.....2....ww
w.w...ww.gw.w
w.3.........w
ww......w3A.w
wwwwwwwwwwwww
