wwwwwwwwwwwww
w........w..w
w..w........w
w...g+3.....w
w...........w
w....w......w
w..........2w
w1..3...A...w
wwwwwwwwwwwww
