wwwwwwwwwwwww
w..w..3w...ww
ww.3.....w..w
w2.....3.3.+w
w.....w.....w
w2.g..3...www
w.A......w..w
w...........w
wwwwwwwwwwwww
