wwwwwwwwwwwww
w1...32..1..w
w..A.233...3w
w...1..w.313w
w...2....33.w
w..+...w.w..w
ww.g..1.2..1w
ww.33.2.w.3.w
wwwwwwwwwwwww
