wwwwwwwwwwwww
w.3ww.....w.w
w.g..w..3...w
w....3.+ww..w
w..2Aw3.2...w
w.w....www..w
w...........w
w.w32w......w
wwwwwwwwwwwww
