wwwwwwwwwwwww
ww.2A.......w
w....3.....ww
w..+.....11.w
wg.w..w...w3w
www.3w1..w..w
w...........w
w...........w
wwwwwwwwwwwww
