wwwwwwwwwwwww
w...gw.w...ww
w..w....w...w
ww..A......ww
w.........w.w
w...........w
w....w....w.w
w+..w....w..w
wwwwwwwwwwwww
