wwwwwwwwwwwww
w.2...w.....w
w......3..2.w
w...A1..2...w
w.........w1w
w...w.....3.w
wg....w.....w
w...3...2w+.w
wwwwwwwwwwwww
