wwwwwwwwwwwww
w....w....A.w
w..w..+...2.w
w....31w.w.gw
ww..ww...w..w
w...3...w..ww
w...w.......w
w.......w.2.w
wwwwwwwwwwwww
