wwwwwwwwwwwww
w..ww..w....w
w...w....2..w
w......2w...w
wA..........w
w..g...w.+..w
w....w.w2.3.w
w.w...w..w..w
wwwwwwwwwwwww
