wwwwwwwwwwwww
wA.......w..w
w....w..w1.1w
w...w....w..w
ww2w..12..www
w...gww..2..w
w2w....2w..ww
w.w.ww23..1+w
wwwwwwwwwwwww
