wwwwwwwwwwwww
w.2.g..w....w
w.......ww.ww
w.....w..Aw.w
w..w+.w...w.w
w.....w.....w
w.........www
w.w....w..w.w
wwwwwwwwwwwww
