wwwwwwwwwwwww
w1w1w+.2...2w
w....w......w
w....3..2..ww
w..11.......w
ww2..23...w1w
w.........1.w
w1A.1.g.....w
wwwwwwwwwwwww
