wwwwwwwwwwwww
w..w....ww.1w
w..w.w......w
www.ww...w..w
w........A.3w
w.....w.ww..w
wg+.........w
w..w....2...w
wwwwwwwwwwwww
