wwwwwwwwwwwww
w...11w.....w
w...........w
w.....1....ww
w.2.3...w13.w
w.....wA.2g.w
w+.2.....w.ww
w.......3.2.w
wwwwwwwwwwwww
