wwwwwwwwwwwww
w.w.....3..ww
w........w..w
ww.gw...3.w.w
w...1Aw..w2.w
ww.....w....w
www.w.3.....w
w..ww.....+3w
wwwwwwwwwwwww
