wwwwwwwwwwwww
w..311..3.g.w
w1..w2.w32..w
w3.32..w213ww
w331..1w..12w
w.3.....1A.ww
w.w31.2...w2w
w333.w...+w.w
wwwwwwwwwwwww
