wwwwwwwwwwwww
w.....w.....w
w...g.......w
w........2..w
w.w.w....1..w
w.w.....w..Aw
w.........2.w
w...+.....w.w
wwwwwwwwwwwww
