wwwwwwwwwwwww
w........w..w
w.w.+w.w..w.w
w.w......w.ww
w.www..A.w..w
ww..gw....w.w
w...w......ww
w.....ww...ww
wwwwwwwwwwwww
