wwwwwwwwwwwww
ww..w.1....ww
w.....A22...w
w.1...1.+2..w
w...1.......w
w.3g.1..w...w
ww..33......w
w....231..w.w
wwwwwwwwwwwww
