wwwwwwwwwwwww
w....+wwww..w
w..1322..122w
www2.11.w3.ww
w....w3w.w.3w
w.1...wwwg.1w
w..w.3..3321w
ww32..w31A22w
wwwwwwwwwwwww
