wwwwwwwwwwwww
w..w.1ww.A.ww
w.2ww.w.....w
w+3w2......ww
w..2.w......w
w.3g1...ww.3w
w3...w.w...2w
ww211....32.w
wwwwwwwwwwwww
