wwwwwwwwwwwww
ww.w...ww...w
w.w.Aww.w.w.w
w.w.w.......w
w........w..w
w.w.w...g..ww
w....+w.w...w
w..w...w.w.ww
wwwwwwwwwwwww
