wwwwwwwwwwwww
ww1.w3.Aw3.2w
w...12w.w3.ww
w.w.ww.1.ww.w
w..3..ww3w.+w
w.ww.www.2..w
w..wwwww...3w
w.g..3..2131w
wwwwwwwwwwwww
