wwwwwwwwwwwww
w.3.3..w.w.1w
w.ww.w..ww3.w
w.3.2w2w3w..w
wwww.w32.w3ww
w1A2.g.2..2ww
w121w+.13..1w
w..33....w..w
wwwwwwwwwwwww
