wwwwwwwwwwwww
w.ww........w
w........g..w
w.w..1.w.ww.w
w......A..w+w
w....2......w
w.....w.ww..w
w....w...w..w
wwwwwwwwwwwww
