wwwwwwwwwwwww
www.w2w2.333w
ww13w.12ww2ww
w.w3..www13gw
w1ww.3w.ww3+w
w3www.2.133ww
www..1.w.wwww
ww.13ww1A.www
wwwwwwwwwwwww
