wwwwwwwwwwwww
w..w.ww.1..2w
wwww.31.11w.w
w.A.3.wwww..w
w31..2w3.1..w
w....23w..2ww
w..w...+1...w
ww.3.w.ww3g1w
wwwwwwwwwwwww
