wwwwwwwwwwwww
wwg.w311..w.w
w...w.1...w+w
w33..1..w.1.w
w..w..1.....w
w....3.w....w
w2111..11A.ww
w23.w3.1w.3ww
wwwwwwwwwwwww
