wwwwwwwwwwwww
w......+....w
ww2ww3..w3..w
w.g......3..w
w.ww.3..22.3w
w.....w1w...w
w....23..w..w
ww.A.ww.2w..w
wwwwwwwwwwwww
