wwwwwwwwwwwww
ww....w.1.w.w
www+.gw1...ww
w1w.www.....w
w.....w.wwwww
wAw.ww...31ww
w.2w.www..www
www3ww1wwwwww
wwwwwwwwwwwww
