wwwwwwwwwwwww
ww..3.1.1.w.w
w31.1.....31w
w2.w2.2...3.w
w3.1.w..w+..w
w.Aw...www1.w
www.w1w.1w.gw
w.3www.w2..ww
wwwwwwwwwwwww
