wwwwwwwwwwwww
w33.2w.+ww..w
ww1w32..1wgww
w..ww2w....ww
w2.33...32w.w
w2w.21.2w3..w
ww.32..2w.w2w
ww.w..A1w.www
wwwwwwwwwwwww
