wwwwwwwwwwwww
ww2.w3.212..w
w32223..1323w
ww.121......w
w2221...321.w
w3+.32.g32..w
w3.33..31221w
w2.2..3A2w23w
wwwwwwwwwwwww
