wwwwwwwwwwwww
w...w1.w..3.w
w...ww......w
w.....g...w.w
w...+...ww..w
w...3w..A...w
w.w.......w.w
w.....3....ww
wwwwwwwwwwwww
