wwwwwwwwwwwww
w..12.1....ww
wA...3g.2...w
w..w1..1.w.ww
w.+.w..ww...w
w.w1..w....2w
w....w......w
w.....2...w3w
wwwwwwwwwwwww
