wwwwwwwwwwwww
www.2...1...w
www.32..2...w
w.2..+w21..3w
w..3.22g1123w
w.2.....21..w
w...A...1...w
ww..21...3.3w
wwwwwwwwwwwww
