wwwwwwwwwwwww
w...........w
w..w3.......w
w......1...ww
w.w.2..w....w
w..1....+...w
w....A......w
w...w.....g.w
wwwwwwwwwwwww
