wwwwwwwwwwwww
w.w1w..1.w.ww
wwwwww.1.21.w
ww.w3A.2w.w2w
w1...w2w..w.w
w1.11.1wwww3w
w.3.w.w+2.1ww
ww..g...w1w3w
wwwwwwwwwwwww
