wwwwwwwwwwwww
w3.2331.31..w
ww.g.12..2.ww
w.2..31..1w.w
w3w21.23.3w3w
wA..2.w1.w.ww
w1....1.w.+.w
w.212.21...3w
wwwwwwwwwwwww
