wwwwwwwwwwwww
w2.1...w1...w
w1..w..+3...w
w.11w33w.w2.w
w1.gw..ww.w.w
w3w..3.33..ww
w.311A.2...3w
w.3..2...2.3w
wwwwwwwwwwwww
