wwwwwwwwwwwww
w133.....A1.w
w1321.g22.11w
w.1w13..3213w
w.1...w2....w
w...w.33.1..w
w.+1.....2..w
w..w321w2.1.w
wwwwwwwwwwwww
