wwwwwwwwwwwww
ww..+ww.2ww.w
wwwAg..w2.w.w
w2...w.w.w..w
w.www2..ww..w
ww.www.w..w.w
w......ww.1.w
w2w.w.1.3ww.w
wwwwwwwwwwwww
