wwwwwwwwwwwww
w...1.w.ww.ww
w.3w23.211..w
w.w..2....+.w
www...w....ww
ww..ww..w...w
w2w..Aw2..w.w
w....w...gwww
wwwwwwwwwwwww
