wwwwwwwwwwwww
w...w.w.1w.ww
w.w.2.+w2w..w
www.w.wwwwwww
w...w3w...www
w..w.....w..w
w..www..g.3.w
wAw...ww.w..w
wwwwwwwwwwwww
