wwwwwwwwwwwww
wwA2+w1ww1.3w
w.2...2wwww.w
w..w.2gww12.w
w.3w23...w.ww
w1..w2wwww.3w
w..w.w.w2.w.w
w.w1w2.2....w
wwwwwwwwwwwww
