wwwwwwwwwwwww
w1.w2+..2..3w
w1.2112.3.w1w
w.11A..1.g23w
w3..23.13w.1w
w3.w..2..w21w
w.312113w113w
w.1113.223..w
wwwwwwwwwwwww
