wwwwwwwwwwwww
w.w.2..3.w12w
w2...w1ww3w3w
w23.w.3.+..3w
w13.w.2.3.www
wwg.w1wA1.www
w32.2.2w23w3w
w3.1w.w.w1..w
wwwwwwwwwwwww
