wwwwwwwwwwwww
w..w.ww3...1w
w1.w.1wA.ww.w
w.w1.w.3...ww
w..3...w..www
w3g....w.3.3w
w.w.+w..ww3.w
wwww22......w
wwwwwwwwwwwww
