wwwwwwwwwwwww
w..ww1......w
w1.+w.w.1...w
w.ww....1...w
w.w..g.w3..3w
w..w.w.w.w.ww
w..2.w.2w...w
wA.w..2..2..w
wwwwwwwwwwwww
