wwwwwwwwwwwww
w..1.212.311w
w1.213.2..21w
w..2.3..33.1w
w1.3.g2.12A.w
w.311.....33w
w.23.3+21.33w
w13w..1.32.1w
wwwwwwwwwwwww
