wwwwwwwwwwwww
w113.13322.3w
ww.331w22.1.w
ww13w..+..32w
ww..w..2.2w.w
w2.31....3.2w
wAg13211222.w
w....31.1w23w
wwwwwwwwwwwww
