wwwwwwwwwwwww
w..31.....3.w
w213..w.232ww
w.1.31.11.2.w
ww32g.3....3w
w..w32.1.2.2w
w.A.22w2..+.w
w13.....w2.3w
wwwwwwwwwwwww
