wwwwwwwwwwwww
ww....w.332.w
w1.g.w....www
ww3....w..w.w
w.2..2...w..w
w.1ww3.w....w
w.2....23.w.w
wA......+..2w
wwwwwwwwwwwww
