wwwwwwwwwwwww
w1..w.www..ww
w1.1..3w..1.w
w..w.w1+.w32w
wg.A....w.www
ww..ww.23...w
w.w.12w.w3www
w1w.w..2.ww1w
wwwwwwwwwwwww
