wwwwwwwwwwwww
w.....3132..w
w..22...2...w
w21.+...323.w
w...1g..1..1w
w1.233..31..w
w.....2A.1..w
w.....23.1.3w
wwwwwwwwwwwww
