wwwwwwwwwwwww
w232.112...3w
w.2.2.3..2g.w
w3.2....2.2.w
w1..2.3w2+..w
w.2..32..3.3w
w..1313112.1w
w...1.2A1331w
wwwwwwwwwwwww
