wwwwwwwwwwwww
w...1...3.13w
w.w1w.......w
w1.w..2....1w
w.w1.+..1...w
w...g21...www
w33....333..w
w11.w..w.A..w
wwwwwwwwwwwww
