wwwwwwwwwwwww
w11.....1A3.w
w3w.3..3..2+w
ww...w....1.w
w.........w.w
w..g33..3..ww
w..2....2w..w
w2..w3..w..2w
wwwwwwwwwwwww
