wwwwwwwwwwwww
w1......21A2w
w3......+.w3w
w..ww.2.ww..w
w..2..3.32.ww
w.2..2....22w
w..w....g...w
w3....w2.2..w
wwwwwwwwwwwww
