wwwwwwwwwwwww
w.2www.w3w..w
w22ww.3A21.ww
w2w.23ww.w23w
ww.ww+31.w33w
wwww.2gw.w2.w
w3w33...ww.ww
ww31.1.ww..1w
wwwwwwwwwwwww
