wwwwwwwwwwwww
w......w3w1.w
w...w2.1w..ww
w2.wg..1ww..w
w...www..w..w
w.w.w..w..+ww
ww.......Awww
www.w3.1.w.ww
wwwwwwwwwwwww
