wwwwwwwwwwwww
w.1.......3.w
w......3....w
w3....1.....w
w........2..w
w..........Aw
w.g...+1313.w
w32......1..w
wwwwwwwwwwwww
