wwwwwwwwwwwww
ww.1..w..2+2w
w3...2w.1ww2w
w.w23..2.2..w
w32w..A31331w
w12..21323w3w
w2w1.3..31.1w
w2w...23g...w
wwwwwwwwwwwww
