wwwwwwwwwwwww
w..A..311..ww
w.w.2.22w2.1w
w...22....+.w
w..1..1....2w
w31.3..23w3.w
w.......2.2gw
w3.3.1111.2.w
wwwwwwwwwwwww
