wwwwwwwwwwwww
w3...ww.w.1.w
ww.3....2.1.w
w....w1w.113w
w2.3..ww22w2w
ww.w2.w.3.13w
w3.2g1.w.2.3w
ww2..2wA.+www
wwwwwwwwwwwww
