wwwwwwwwwwwww
w1.233w3.1w1w
w1.www.2w1.ww
w.w.2.3w2w+3w
ww.....1.2w1w
w3g..2A1.w.ww
w32w...2.33.w
w1w..3...3..w
wwwwwwwwwwwww
