wwwwwwwwwwwww
www.2.w.1w23w
w..1.w..ww.ww
w2.ww.2..w.Aw
w..1.1w.2w..w
w..w21+w.w..w
w31..w.13...w
w21...w..g..w
wwwwwwwwwwwww
