wwwwwwwwwwwww
w1..23w.31..w
w3.+3131.313w
w1..1..w21g.w
w.332.13w2wAw
w33.313..332w
w..12.3.....w
w33..1121...w
wwwwwwwwwwwww
