wwwwwwwwwwwww
w.3w....wA.1w
ww23...2w11ww
w11w2.w+12.ww
w....11w..www
w.w13.1.www.w
ww2.3..3.2.ww
w3w.w..w2..gw
wwwwwwwwwwwww
