wwwwwwwwwwwww
w11w..3..w..w
w3...wg1w..1w
ww32w...w1..w
w.23.....A13w
ww....ww1w.1w
w.w23w.w1w..w
w.12ww3ww2.+w
wwwwwwwwwwwww
