wwwwwwwwwwwww
w....2..2...w
w2223.13.112w
w.3.A2.21112w
w+3.....3.21w
w123.1.....1w
w3111.3..g..w
w1.32.312112w
wwwwwwwwwwwww
