wwwwwwwwwwwww
w3.2.2..1..1w
w......+....w
w.3....2....w
w..2....12..w
w........3g.w
w.2...3.A..ww
w3333.12.213w
wwwwwwwwwwwww
