wwwwwwwwwwwww
w......2....w
wg.2.....3..w
w....2......w
w...........w
w...........w
w..A........w
w........+..w
wwwwwwwwwwwww
