wwwwwwwwwwwww
wAww.+w.....w
w1.3w3w33...w
w3..13.w.22.w
ww1..w3.1..2w
w...w.w.2.1ww
w.1w1..2..31w
w2.......gw.w
wwwwwwwwwwwww
