wwwwwwwwwwwww
w222.g2...2.w
w2..33....1.w
w2.1.3.3....w
w21.....3.1.w
w.A3........w
w.2....3...+w
w..2...2.311w
wwwwwwwwwwwww
