wwwwwwwwwwwww
w.2..+..2.2.w
w.12g2.12213w
w.12w1w13.1.w
w13..3..1.13w
ww.3.2w..ww.w
w3A.1w3...3.w
w.w.22..12..w
wwwwwwwwwwwww
