wwwwwwwwwwwww
w..ww2...2..w
w3.ww13.w..2w
ww.23....13.w
w2..www+2..ww
w.w.2.3.w...w
w.w2.33w.1www
w2.133A2..g.w
wwwwwwwwwwwww
