wwwwwwwwwwwww
w...332.3...w
w..2.2....+.w
w33231g.1..3w
w....1.233..w
w...31....32w
w21.21..1..1w
wA.1.12.122.w
wwwwwwwwwwwww
