wwwwwwwwwwwww
w.g.222...33w
w11w2.2...32w
w133....3.3.w
w.111.2.w.3.w
w...1321.w3ww
w.w2...w3..ww
w.2232.3+3.Aw
wwwwwwwwwwwww
