wwwwwwwwwwwww
ww.....w2..3w
w.ww....1w..w
w..2.g.ww..ww
w.....2w.3.ww
ww2...2w2...w
w2ww....ww+.w
w..w33A.....w
wwwwwwwwwwwww
