wwwwwwwwwwwww
www...1.w311w
ww.1.3w1w2w.w
w..1g..1.ww.w
w.w.3ww3.ww1w
w3.32ww.w.www
w.2wAwww.1.ww
w+..3.w.213.w
wwwwwwwwwwwww
