wwwwwwwwwwwww
w......1.1..w
w.......Ag.3w
w..w...1....w
w........w.3w
w1...+......w
w.w.w..22.3.w
w.w........3w
wwwwwwwwwwwww
