wwwwwwwwwwwww
w...3.2..A2.w
w123..13.2..w
w3231323..+2w
w...222.1.23w
w2g3222312..w
w3333.1.2...w
w13...3.21..w
wwwwwwwwwwwww
