wwwwwwwwwwwww
w31.1.3313.2w
w.31231A.31.w
w32..321..1.w
w3..11313..3w
w..21...3.+.w
w..1.2.1.13.w
w132g1312213w
wwwwwwwwwwwww
