wwwwwwwwwwwww
w.3ww2.211..w
w231w..A13..w
wg..w3w3ww2.w
w3w.w+21w213w
w.13..3w.12ww
w2w31w..1ww.w
w.1..1w22.w3w
wwwwwwwwwwwww
