wwwwwwwwwwwww
w...1.1..3..w
w1...3323.32w
w22.3......ww
w22w331w32..w
w+331..13..1w
w...1.21g.1.w
w...3A..21w1w
wwwwwwwwwwwww
