wwwwwwwwwwwww
w2..3.ww1213w
ww....31.w3.w
w3.1.312.wg2w
w2.A.2..1.33w
w12.+w.21..1w
w...22w11313w
w3w.w2.1.121w
wwwwwwwwwwwww
