wwwwwwwwwwwww
wg.23.A31.w3w
w322..11w213w
ww3w2w3w3w3.w
w.ww12w.3..ww
ww2.w.3.1...w
ww2233111..ww
w..111w...+.w
wwwwwwwwwwwww
