wwwwwwwwwwwww
w...w..ww.2.w
w...21w..+.ww
w..w.g.w....w
w...2..w.A..w
w....1.3.3..w
w3...21.ww..w
w.3.1.2..3.2w
wwwwwwwwwwwww
