wwwwwwwwwwwww
w111......11w
wg...11.1112w
w.222..2.2..w
w32...A11133w
w22..21132+.w
w1.3....1222w
w21...3111..w
wwwwwwwwwwwww
