wwwwwwwwwwwww
w...2.....2.w
w..3.32321..w
w+32.211.2.ww
w1...3.11.13w
w.w.12.g3211w
w..1....3332w
w22.w.32A1..w
wwwwwwwwwwwww
