wwwwwwwwwwwww
ww...g2.....w
w.11w.w.3...w
w..2..1.1...w
w1w3.ww22...w
w+1..1w.....w
wA1..3...231w
w.2w.w12.2.2w
wwwwwwwwwwwww
