wwwwwwwwwwwww
w.3.w.w..3..w
w..........2w
w11.3.....3.w
w....w..33..w
w2..2...g..1w
w+.A3.22.ww.w
w..3.1..13..w
wwwwwwwwwwwww
