wwwwwwwwwwwww
w2122.w2.332w
w212...33g.+w
w2..1.313..ww
w.232.231...w
w1.....21...w
w.2.....A23ww
w..31.3.12www
wwwwwwwwwwwww
