wwwwwwwwwwwww
w..w2.3....1w
w..w.1...3w.w
ww..w.2...2.w
w......w.w+.w
w2.g..ww.w..w
w...3.1w..w.w
wA1ww222....w
wwwwwwwwwwwww
