wwwwwwwwwwwww
w2.w113w+.3ww
w.1.211Aw.2ww
w3w11.22w.w1w
ww31.2.3221.w
w3g3.132.1w3w
w..1.3..3..ww
ww3...1.231.w
wwwwwwwwwwwww
