wwwwwwwwwwwww
w.33......3.w
w.21...1.2..w
w.221..2.3+ww
w.1......g..w
w..2.w1.2A.1w
w..23..13.3.w
w22.12.3...2w
wwwwwwwwwwwww
