wwwwwwwwwwwww
w.1www...w3.w
w....w.22..ww
ww3w1..+...ww
w...wwwwww..w
w3w.....Aw..w
w..2w1233.2.w
www2..wg1..ww
wwwwwwwwwwwww
