wwwwwwwwwwwww
w1w1.www2ww3w
w.2.23.w1wwgw
w.21w.2231w1w
w3wAww..+...w
w1.w..2.....w
wwwww..1w.www
www311.1w1.ww
wwwwwwwwwwwww
