wwwwwwwwwwwww
ww...w..w.w.w
ww....w.w...w
w....w1..w.ww
w......w1w.ww
ww.ww...g..ww
w..wA+.w...ww
www..ww1...1w
wwwwwwwwwwwww
