wwwwwwwwwwwww
w.3..1..w132w
w2..3313A.1.w
w.1.2w.11.13w
w.3213.1...1w
w2.333.w2w1.w
w3312311wgw+w
w1..1....3.1w
wwwwwwwwwwwww
