wwwwwwwwwwwww
w1.1..g3....w
w33..w2.....w
w.1.....+3..w
w.2.....22.2w
w22.....3.w.w
w3.2......2.w
w22.......A3w
wwwwwwwwwwwww
