wwwwwwwwwwwww
ww31..233332w
w.333..A3.1.w
w.31..331.12w
w33w1w3.1322w
w2.w.13...21w
w..3..23.2.3w
w22.+21.1g..w
wwwwwwwwwwwww
