wwwwwwwwwwwww
w.......3...w
w33..3.1.2..w
w.2..1.+.1.2w
w....1...11.w
w..w...32.2.w
wA2g1.......w
w2.....3...3w
wwwwwwwwwwwww
