wwwwwwwwwwwww
w...........w
w.......w...w
w.....1.....w
ww.w.gA..w..w
w..w..+.....w
ww.31....w..w
w...........w
wwwwwwwwwwwww
