wwwwwwwwwwwww
w1...1.2..11w
w2.211222g..w
w.1+1w2.1..1w
w.3.33.1.w3.w
w21.w2.21331w
w...3.....3ww
w22..2222A1.w
wwwwwwwwwwwww
