wwwwwwwwwwwww
w.1........3w
w1...2.1.1.1w
wA1.3....+.2w
w2.1...3.3..w
w.3.2...1...w
w.1.g.22.w2.w
w1..11.233..w
wwwwwwwwwwwww
