wwwwwwwwwwwww
w.A.....3..2w
w33.3...12..w
w.21...1.1..w
w..33.....2.w
w11+.1.11...w
w.g231..1.32w
w......12.12w
wwwwwwwwwwwww
