wwwwwwwwwwwww
ww.3...A3.2.w
w21.+ww1.2..w
w..2133w22..w
ww3..322.g..w
w111.2w233.2w
w.......2311w
w1w2..23.3w3w
wwwwwwwwwwwww
