wwwwwwwwwwwww
ww2.w..221.2w
w..w.1+2.2.Aw
w.w.22.1.ww.w
ww.1.3w.ww..w
w1..31......w
w31.w...3w..w
w12gw...1.w3w
wwwwwwwwwwwww
