wwwwwwwwwwwww
w.........3.w
w.21.3.2.3.1w
w.........2Aw
w.1..2..+21gw
w....21.1...w
w..1...31..2w
w.....1.2..1w
wwwwwwwwwwwww
