wwwwwwwwwwwww
w1...Aw3..2.w
w..3.....ww.w
w.....1.....w
w3....+.....w
wg.......ww.w
w......2....w
w.1..3......w
wwwwwwwwwwwww
