wwwwwwwwwwwww
w3.3w1.2.1..w
w.3..3.3....w
w3.23......Aw
w3.3.1.w..2gw
w....3....2.w
w.+.......3.w
w.....1.1.2.w
wwwwwwwwwwwww
