wwwwwwwwwwwww
w1.133.11..+w
w.2..12g.13.w
w.2.1ww.A.21w
w...22.....1w
w.3...32...3w
w3w1.3.12..3w
ww....w11w2.w
wwwwwwwwwwwww
