wwwwwwwwwwwww
w.w.w..g..1.w
ww1.2w.....+w
w..3.......2w
w2.3123.w.2.w
w33.2..3A2..w
w1..3233.w.2w
w..33..22..1w
wwwwwwwwwwwww
