wwwwwwwwwwwww
ww2.w32..223w
ww33222.1ww1w
w.31.1w..w.1w
w3w...321ww3w
w.w2..+1w1..w
ww.32w.233.2w
wA2.g1w32wwww
wwwwwwwwwwwww
