wwwwwwwwwwwww
w.3w.12A232.w
w.2.1.w...2.w
w3..g.2.2+..w
w3..13.11..2w
w...2.2.1231w
w....w1.3.3.w
w..32.1.33.3w
wwwwwwwwwwwww
