wwwwwwwwwwwww
w.3ww3.1w3..w
ww22w.wA3w.ww
w2..33311ww.w
w1..w3ww113ww
w.w2..23.w3+w
www121..213.w
w.2w.3312..gw
wwwwwwwwwwwww
