wwwwwwwwwwwww
w.....2.2wwww
w.A32w12....w
w.1.3.3...w.w
ww22..gw.32.w
w1w.w.......w
w...1....3w.w
w....www1.+ww
wwwwwwwwwwwww
