wwwwwwwwwwwww
w..A3.23.w..w
w.12.......2w
w.22.w.w..w.w
w21.w21w+1..w
w12.1....g.2w
w.w.1w..wwwww
ww..........w
wwwwwwwwwwwww
