wwwwwwwwwwwww
w..1.w3..3g.w
w...11..ww2ww
w...w1w.w.32w
w2.23..1.2w.w
w..w2w.1..33w
w.31ww+.w..1w
w3.w.2A2...ww
wwwwwwwwwwwww
