wwwwwwwwwwwww
w.A.w..wwg.ww
w3w....w.11ww
w223w....+1ww
w..21w.w...2w
ww..w.2ww2.ww
ww.w31.3.w13w
w..w2.w.w..1w
wwwwwwwwwwwww
