wwwwwwwwwwwww
w21ww3g1w.wAw
w3+w232.ww.2w
w3w133...11.w
w..1www12w2.w
ww.w..ww13.1w
w2.w.w.w.w.1w
ww.ww3..ww..w
wwwwwwwwwwwww
