wwwwwwwwwwwww
w.1........ww
w...ww..w...w
w.w...A...www
w.+.1.2....ww
ww....32.1.gw
w....1ww....w
w....2....3ww
wwwwwwwwwwwww
