wwwwwwwwwwwww
w3www.3....+w
wwA.13w.1w.3w
ww21ww.2.ww.w
w.ww3.wwwww.w
w.w.w2wg3..3w
w1.wwww.w.w1w
www.ww.ww...w
wwwwwwwwwwwww
