wwwwwwwwwwwww
w.3...+.....w
w1.....2....w
w3...2w3....w
w.A...22...1w
w....1.1....w
w1.....22w..w
w.....g.....w
wwwwwwwwwwwww
