wwwwwwwwwwwww
wg...332..3+w
ww.11...3..Aw
w31...21.111w
ww...22w12..w
w1.233.2.2.2w
ww1...32w..2w
www.3.......w
wwwwwwwwwwwww
