wwwwwwwwwwwww
wA...ww.ww..w
w...www32..gw
w.....+.....w
w33w....ww..w
ww.....ww...w
w.w..1w3.w1.w
w..w..1w..3.w
wwwwwwwwwwwww
