wwwwwwwwwwwww
ww..2...ww2ww
w....w2w13..w
ww.Aw.+w.ww.w
w3.2w...www.w
ww.www...ww.w
wg.2.ww3.ww1w
ww1..2www..ww
wwwwwwwwwwwww
