wwwwwwwwwwwww
www.w..w.w.ww
w...2ww2...ww
w1ww.ww.wwwww
www.www.ww.+w
w.2.1w.w1wwgw
ww.2A...w2w.w
w.w.w3.2....w
wwwwwwwwwwwww
