wwwwwwwwwwwww
w....211w..2w
w..2......2.w
w..w13.213..w
w......1..32w
w.2..2+...3.w
w1gw...3A.3.w
w...w.1w.w.ww
wwwwwwwwwwwww
