wwwwwwwwwwwww
w3w.w112.2w2w
ww......2wA3w
w12.212.2..1w
w.w.3...1.www
w.3.1.ww.23ww
w.+w....1.23w
ww.312.2.g3.w
wwwwwwwwwwwww
