wwwwwwwwwwwww
ww.w3...ww1ww
w.w...2.....w
w3w..w.w...ww
wwww13......w
ww..w..w.g.Aw
www.1w.3+1.ww
w3....23..3.w
wwwwwwwwwwwww
