wwwwwwwwwwwww
w332.g....1.w
w31w.22...2.w
w12.23.1..31w
ww1.3.......w
w.22.133.+.3w
ww2...31..13w
w1..2.2.1A.3w
wwwwwwwwwwwww
