wwwwwwwwwwwww
w.......+.1.w
w...........w
w...........w
w......A....w
w....w2...w.w
w2.....g....w
w.......w1w1w
wwwwwwwwwwwww
