wwwwwwwwwwwww
w.......+.g1w
w.......1...w
w......1....w
w12....A2..1w
w.2..w2..23.w
w33...13..22w
w........1..w
wwwwwwwwwwwww
