wwwwwwwwwwwww
ww311..12ww.w
w2...w3..3.ww
w.g13w..A.33w
ww.2w.3.....w
w.3..2.....ww
w111+..w..3.w
w...3w3.21w.w
wwwwwwwwwwwww
