wwwwwwwwwwwww
w.1.1w2.w.1.w
w..ww.w3ww.ww
w.w.3ww.1.1.w
ww.g..+..w3ww
w....w.A2w.ww
w.w.2..33ww1w
w2ww.2w.23..w
wwwwwwwwwwwww
