wwwwwwwwwwwww
w2....13..3.w
wg...w...w.ww
w...23...w.1w
ww...ww.Aww.w
w...+ww1.w..w
w.ww....w..ww
w...w3w3w...w
wwwwwwwwwwwww
