wwwwwwwwwwwww
w.w.wwwww+2ww
www.w1...w.gw
www2....w..3w
w..3...w2.w.w
w.ww....1w.ww
ww223ww3www.w
w.2.wwA...www
wwwwwwwwwwwww
