wwwwwwwwwwwww
w3ww3w+.w3.ww
www.w3.wwww.w
www.w2.3.g1ww
w1.w.32.wA.1w
ww.wwww.w.www
ww2...w.ww1.w
ww.w2w.1w...w
wwwwwwwwwwwww
