wwwwwwwwwwwww
w.w........2w
wA1.2+w.3...w
w.w..323....w
w1...w....w3w
w.....2..g..w
w...1..ww...w
w...21w1..w.w
wwwwwwwwwwwww
