wwwwwwwwwwwww
wg+w.w...w.ww
w....www.1w.w
w..w.w3.3...w
w..w.1.w2..3w
w..Aw...w.w.w
w....ww..1..w
w.....321...w
wwwwwwwwwwwww
