wwwwwwwwwwwww
w.13..2g1.w2w
w3.ww.w....3w
w2.w+...1..3w
w33..2w..2..w
w...122w.w2.w
w.A.3..w.w2.w
w2w2.23.2.w3w
wwwwwwwwwwwww
