wwwwwwwwwwwww
ww+..31.3.www
w.w.3www.w.ww
www.w3..1.www
w23w3.1wwA2ww
w1...ww1..w1w
w323w.g1.w12w
w2.w.w.3223.w
wwwwwwwwwwwww
