wwwwwwwwwwwww
w.w3w.w+..13w
w.w..ww....ww
w....2w1w.g.w
w2.332..3..3w
w.3...w..wwww
w..w...12.w.w
w3ww.A.w3w31w
wwwwwwwwwwwww
