wwwwwwwwwwwww
wA.113w..w..w
w.w.2w..3...w
w..w.w.w.w..w
w+w.1...2..3w
w2.w......w.w
www...3www.ww
wg..ww.w1.3.w
wwwwwwwwwwwww
