wwwwwwwwwwwww
wA.3.3w..2.1w
w.ww12..w..ww
w.ww..w..2.ww
ww..w1.w13w.w
w1.www2w.w3ww
w2wwgw..ww.1w
www23..+1.w.w
wwwwwwwwwwwww
