wwwwwwwwwwwww
w......w1g1ww
wwww....w..ww
w.+.w...ww..w
wAw..w.w....w
ww........www
w.w...22.ww.w
ww.ww..w.w.ww
wwwwwwwwwwwww
