wwwwwwwwwwwww
w.3wwww112.ww
w.A.w..ww13ww
w.w.w.1.1.w.w
ww.3..ww..2.w
w2ww..2www.ww
w.2.g.w3..1+w
w..1.w...w..w
wwwwwwwwwwwww
