wwwwwwwwwwwww
w2w.12g+...2w
w..w........w
ww.....32..ww
w...11w...3.w
w.3...w.w3w.w
w.w3...A...1w
w.w.2..3.13ww
wwwwwwwwwwwww
