wwwwwwwwwwwww
w...w2..w...w
w..12.w.1..1w
ww...w.w.2www
ww23w1.ww133w
wwww..3.A.+.w
www1.w2.w.w.w
w3ww.g.w..w.w
wwwwwwwwwwwww
