wwwwwwwwwwwww
ww.3...3www2w
w..w1..ww.3.w
w13..1...+22w
w....wA.w22.w
w.g..1ww3.w2w
w.w13w..13..w
w2.2ww.....1w
wwwwwwwwwwwww
