wwwwwwwwwwwww
ww..2.gwwww1w
ww.2w.1....+w
w232w..2w.www
w3.w.3w.3.w.w
ww.....www..w
w.w.A.w...w.w
w.w2.1.www.2w
wwwwwwwwwwwww
