wwwwwwwwwwwww
w.....ww2w..w
w33......gw.w
w3ww1w.3..1ww
w....2w.22+.w
ww1.w2...ww.w
ww..2w...Aw1w
w..1.13.w..2w
wwwwwwwwwwwww
