wwwwwwwwwwwww
w.3.g.1.w.w3w
w232w.w22222w
ww.ww.www.Aww
w.2...2.1w..w
ww..ww...3..w
ww+2w1w2.231w
w.ww...ww.www
wwwwwwwwwwwww
