wwwwwwwwwwwww
w...2..w3w31w
ww....1..111w
w....g2w1+.1w
www23...ww3.w
w.w23.w1.w1.w
ww.231A31..2w
w..3.w3w.w3ww
wwwwwwwwwwwww
