wwwwwwwwwwwww
ww..w....w.ww
ww...w...wg.w
ww.....w....w
w.w...w..3..w
w..1......www
w+A.....w.w.w
w.....w.1...w
wwwwwwwwwwwww
