wwwwwwwwwwwww
w.13g..3...ww
w..2A..ww.www
wwwww.w..13.w
www+.ww..2w.w
w.....w32.www
w.w1.w..w...w
ww2w.22..wwww
wwwwwwwwwwwww
