wwwwwwwwwwwww
w....w.13w.3w
w.w121.w.2..w
ww.wA.w1.1.gw
w..1..3.w..1w
w.1..w+ww..ww
w.ww.ww.....w
ww..w3w.w..ww
wwwwwwwwwwwww
