wwwwwwwwwwwww
ww..w.22..3.w
w.ww.....w..w
ww.gw.3..3.2w
ww.+ww.3w..1w
ww2....w.wAww
w1......ww..w
w.....w.....w
wwwwwwwwwwwww
