wwwwwwwwwwwww
wwA...3w2122w
w2....21w.w.w
w.1..3...+.1w
w..ww2.2.w..w
w2..3.2g.3..w
www..11..1w3w
w133.......2w
wwwwwwwwwwwww
