wwwwwwwwwwwww
ww3.2.w..ww.w
w.1.w3.w31.gw
w..1ww..w.www
w+w..3w..2.3w
w3..w.w.ww3.w
w..www.w.w.2w
ww.1.w..A...w
wwwwwwwwwwwww
