wwwwwwwwwwwww
w...ww1w...ww
ww.........ww
w.w.3.w.ww..w
w...2w.+..w.w
w3www.....w1w
w..w.w..g...w
w..A.w..w2.ww
wwwwwwwwwwwww
