wwwwwwwwwwwww
ww1...w.w3.1w
ww....ww.w.1w
w3w..Aww.ww.w
w..........ww
ww.w.3.w....w
w22.ww...w1.w
w....3.wgww+w
wwwwwwwwwwwww
