wwwwwwwwwwwww
w11...w.12w.w
w.w.3w.....Aw
www2.w.2ww.2w
w........2g2w
w..2www..w..w
wwww.3.ww.13w
w11....+1.w3w
wwwwwwwwwwwww
