wwwwwwwwwwwww
w..w2ww..1w.w
w..3.g..1w.1w
www....wA.w.w
ww..ww....www
w..1.w.....ww
w+.........2w
w.w.3...w.w.w
wwwwwwwwwwwww
