wwwwwwwwwwwww
ww..........w
w2w....ww.www
w.1w.ww.ww1.w
w...1.w1..3.w
ww.1gw..w...w
w.Aw..w..w..w
w.+..1ww..w.w
wwwwwwwwwwwww
