wwwwwwwwwwwww
w....2.+w...w
w.223..w....w
w.1.....w11ww
w2.2w...w..1w
ww...w.2w.w.w
w.Aw3.w.11.gw
w.2...2.12..w
wwwwwwwwwwwww
