wwwwwwwwwwwww
w+33...w.1.2w
w2.3..w.....w
w.w..22w1...w
w2.1.1..w..Aw
w33.....w3.ww
w2w.32w.2...w
w33..1g....1w
wwwwwwwwwwwww
