wwwwwwwwwwwww
w..3ww1.1ww.w
w+.w3ww..ww.w
w......ww..ww
wgw.1.wwww2.w
w1w..www..www
w12.ww...Awww
www...3....ww
wwwwwwwwwwwww
