wwwwwwwwwwwww
wg.12w.2w.w.w
ww......22w.w
w...w2w1.w.ww
w2.w.www.w12w
ww.A....ww..w
w....+.www.ww
w1..w3.w....w
wwwwwwwwwwwww
