wwwwwwwwwwwww
w.w2......23w
w2wwww....w.w
w.2.1w.w..www
w.g......+.1w
w.2..333ww..w
www....1..www
w3122w1w32A1w
wwwwwwwwwwwww
