wwwwwwwwwwwww
w2...w2..+A1w
wwwww.w1w.2ww
ww.....w.w.gw
w..........ww
ww.1..3..w.ww
w...w1.w1w..w
w.2.3.......w
wwwwwwwwwwwww
