wwwwwwwwwwwww
w3.1www.1.g.w
ww.wA+....2.w
w1...ww3w2..w
w...3w..www.w
w......w.1..w
w...3.w..w..w
w...w.w3..www
wwwwwwwwwwwww
