wwwwwwwwwwwww
w.w.2w.w.ww.w
w.ww1w1ww..ww
w.1.g.ww.w..w
ww..2.....www
w.221...Aw+.w
w...21w..2..w
w3w1w.3.3.www
wwwwwwwwwwwww
