wwwwwwwwwwwww
w...33.ww.3ww
ww..2..w....w
w2.....3...ww
w3...w.g.wwww
w.3w+w1w.A..w
w.1ww2w....ww
w..1w13.w22.w
wwwwwwwwwwwww
