wwwwwwwwwwwww
ww3ww.www..gw
www.w1.ww...w
w..3ww2..311w
w2..1.3..w.ww
w+...ww.www.w
wwwA2.w2w3w.w
ww.23w1..w21w
wwwwwwwwwwwww
