wwwwwwwwwwwww
w2w...3w..1gw
w1ww2.1.1ww.w
w.ww.ww.1wA1w
ww13w+3ww3w3w
ww2.ww212ww.w
w12.w2.w11.1w
www.w221.wwww
wwwwwwwwwwwww
