wwwwwwwwwwwww
ww.3.3.gww.1w
w.wA3.w.3.2ww
w32.3w.ww...w
w1w...23...ww
w2..ww+w.2www
w2.w.23..w32w
www3w.2.w.www
wwwwwwwwwwwww
