wwwwwwwwwwwww
www.w..w..www
w.w2wwww2..1w
w..w..w.w...w
w3.+.2..w...w
www.w.w.3.w1w
w2.Aw..w....w
w.w.3w3...g.w
wwwwwwwwwwwww
