wwwwwwwwwwwww
w33w..3ww333w
w...13ww3.33w
w..1.g...w..w
w..w1+.2...Aw
w....w.w.3.2w
w.2w...3..1.w
w.3......1w2w
wwwwwwwwwwwww
