wwwwwwwwwwwww
ww.3w...1..3w
ww...www.w..w
w1.w.ww.w.2.w
w3+.21w.....w
ww.w.A...w2.w
w2w.....w.g3w
w3w2..ww.w2.w
wwwwwwwwwwwww
