wwwwwwwwwwwww
w...3...A..ww
w.....131...w
w1....32ww..w
w.1..g...22.w
w.1.w....2..w
w.+w3..ww.1.w
w..w..3w.w1.w
wwwwwwwwwwwww
