wwwwwwwwwwwww
w.w.w1..w.w3w
w11w.23w2w+ww
w2ww.w3A3..3w
w132.3w3.1w1w
w.2...ww.w..w
www.w.w1gw.ww
w.w.23ww..32w
wwwwwwwwwwwww
