wwwwwwwwwwwww
w..ww.ww2w.ww
w..w...w.w3ww
w2A1.+www.w.w
ww2....3..2.w
www2w.w..2g.w
w..w.2w.1..ww
www...www..ww
wwwwwwwwwwwww
