wwwwwwwwwwwww
wA..3..w2.w.w
w2w..2..2...w
w...w..ww2.ww
ww.2.w.3w.1ww
w21.3..g....w
w..wwww3+...w
w..1.1w.11w.w
wwwwwwwwwwwww
