wwwwwwwwwwwww
w...w...3w.ww
wg3w..ww.+..w
w3..3w..w.2.w
www..ww.1.3.w
ww2.w....w..w
w....wA..3w.w
w.w3.2w.w.w.w
wwwwwwwwwwwww
