wwwwwwwwwwwww
www.1.w..3w.w
wA..1.w..w.+w
w22.3.gww.2.w
w.2w3..w.w.ww
ww.2w1.w.3..w
www.w.....3.w
ww2..2.3.w.ww
wwwwwwwwwwwww
