wwwwwwwwwwwww
w....+.1.2.3w
w.w2.1ww2...w
w..1.w13w..ww
w.....1.w...w
w.3g....w...w
wA.1.32..w1ww
ww1.2.2.3...w
wwwwwwwwwwwww
