wwwwwwwwwwwww
w2...+2w..3.w
w2..w......3w
w.w..A.....2w
w..w.1w.3g..w
w.w.1w23.w..w
w.1w......w2w
ww..w2ww....w
wwwwwwwwwwwww
