wwwwwwwwwwwww
w..w.ww..1A.w
w3w1+w.w1w..w
ww.w.g11....w
w2w.w2w..wwww
ww..w2w2.w1ww
ww.ww..w.w..w
w1w31.2.3.w.w
wwwwwwwwwwwww
