wwwwwwwwwwwww
ww.......2..w
w.3.1w.3w33ww
w333w..3..w3w
ww133.wwg..3w
ww...3...A..w
w.....3.1+.3w
ww1w3w221w.ww
wwwwwwwwwwwww
