wwwwwwwwwwwww
w..wwww....1w
w31....3Aw..w
ww.+ww.ww.3ww
w1...w.1...ww
w3.3...w.g3.w
w13..ww1.2.ww
w.w23ww..wwww
wwwwwwwwwwwww
