wwwwwwwwwwwww
w.......1..ww
w2.w1.1....1w
w.w...w...w.w
ww3..2..www.w
w.+.w.w.....w
wwAwwww.gw..w
w1..ww...ww1w
wwwwwwwwwwwww
