wwwwwwwwwwwww
w.w.1......1w
w.ww.www2..ww
w.w..w.w1w..w
w1w3w..w+3.3w
w...w...3..1w
w1ww..w22wg.w
w.3.31.wAw..w
wwwwwwwwwwwww
