wwwwwwwwwwwww
w..23A..w..ww
w.3..w...w.ww
wwwgw11.ww.ww
www..w.w2.w2w
ww.www3w.1..w
w.2..2..www.w
ww+2.ww.w.w.w
wwwwwwwwwwwww
