wwwwwwwwwwwww
w2ww..w..w.1w
w3.....ww1.ww
w...wwwwww.Aw
w....+..w1..w
w..3.w2..3.ww
w3..3.2wg...w
w.ww.w..1.www
wwwwwwwwwwwww
