wwwwwwwwwwwww
w..+1331ww3.w
wA.1.w3..w3ww
ww....1.w1w2w
w21.gw2...w1w
ww..wwwwwww2w
wwww.wwww1..w
www2w...ww.2w
wwwwwwwwwwwww
