wwwwwwwwwwwww
ww2.2ww..3..w
w.1.w.w...w.w
ww.ww...w.A2w
w...ww.1..w.w
w1.w+.31w...w
w..3.w.2w.3.w
wg...22.....w
wwwwwwwwwwwww
