wwwwwwwwwwwww
w2.g..w2.w1.w
w.ww1....A..w
w....w2.....w
ww...w.w.ww.w
www..+.www..w
www.13..w.w.w
w2w.3.w.3..ww
wwwwwwwwwwwww
