wwwwwwwwwwwww
w..2...2.w2.w
wg1112+1.132w
w2.2.2w...12w
ww.2..2w.1..w
ww..1wwA.w.2w
w1..123w..2.w
ww13.w......w
wwwwwwwwwwwww
