wwwwwwwwwwwww
ww3w3.w2.2.ww
w.w.3..w2.www
ww22w....3w.w
w..w2...w.www
w.+...ww321.w
wA.w...3.ww.w
w...w.g..w..w
wwwwwwwwwwwww
