wwwwwwwwwwwww
w2..1..w..1ww
w2.w...www.ww
w.gw1....3.ww
www..w..w...w
w.w..ww.www+w
ww..ww.wwww.w
w.w.wA....13w
wwwwwwwwwwwww
