wwwwwwwwwwwww
w1ww.w2..ww2w
w2+....31w2.w
w3w.1.1wwwwww
w1.3w.2wg1www
w.ww...w1w..w
w1.1.2....2ww
w...A1w..3..w
wwwwwwwwwwwww
