wwwwwwwwwwwww
www2.w.....1w
w1w3ww33wwwww
w1..ww3...3.w
ww.3ww.w.wwww
wAg1+w...ww.w
w...www.1.w2w
w13w.1...w..w
wwwwwwwwwwwww
