wwwwwwwwwwwww
ww2..w..g.w1w
ww.3.www..32w
ww.w..w.w3..w
www....A....w
w.w.w.2.....w
w.w.w..w3w3ww
w.+..w32.ww.w
wwwwwwwwwwwww
