wwwwwwwwwwwww
ww1w.ww.ww..w
w3w1.ww..w.ww
w.ww...2...2w
w1w.w..w..11w
w2w.wg.ww...w
w1.2.+w.w3..w
wA.w.ww.213.w
wwwwwwwwwwwww
