wwwwwwwwwwwww
w....w3w1.w2w
w.w....+..1.w
ww.w2ww3...2w
www.3www.1w1w
w...g.w....ww
w.2...Aw3ww2w
w.w..2.....1w
wwwwwwwwwwwww
