wwwwwwwwwwwww
w..3.g+w.w.ww
wwA.w.......w
w2.3..1w.w.ww
w...w2.w.2..w
w...ww....w.w
w..w..w..w.1w
w.ww......www
wwwwwwwwwwwww
