wwwwwwwwwwwww
w.....311...w
ww.23..+..w.w
w......ww.www
w......3...1w
w.......w..Aw
w..........3w
w.3w....w..gw
wwwwwwwwwwwww
