wwwwwwwwwwwww
w1.2..1..3w.w
ww...ww3..www
ww..w.www2www
ww3w....1...w
ww.3..wA.ww.w
w..ww...2ww.w
w..gww.+.w.ww
wwwwwwwwwwwww
