wwwwwwwwwwwww
ww3.w.w..w.ww
ww..33..w..ww
w1.ww.ww.Aw.w
w...ww..w.w.w
w2w...w.w2w1w
w21.w.31g2..w
w.w3.+www..3w
wwwwwwwwwwwww
