wwwwwwwwwwwww
ww.w+..w.ww3w
w1..w....g..w
w...3..www.ww
w...A2..1.www
www2.3.w3.w1w
w...w.w.2w..w
w.3w.w.www32w
wwwwwwwwwwwww
