wwwwwwwwwwwww
www2ww2.ww2.w
www1.w.w...ww
w33w.12.w...w
w.w...33.w.3w
w..wg+.w3.w.w
w1.w.3w....2w
w.3w1w..3wA.w
wwwwwwwwwwwww
