wwwwwwwwwwwww
w.w..w+..w.ww
w223www33w.3w
w.www1w.ww.ww
ww.....333w3w
w.g..2A2ww.ww
w...w.ww2ww3w
wwwww.ww3wwww
wwwwwwwwwwwww
