wwwwwwwwwwwww
ww3w......w.w
w.w221wwwww.w
w...A.w21ww.w
w...ww.w.w3ww
w.w....2..3ww
w+......w.2.w
w.2..g2..w.3w
wwwwwwwwwwwww
