wwwwwwwwwwwww
ww.....w3ww.w
wwwAww.2....w
w1....w.w+2ww
wwwww.wwwg..w
w3w.......1ww
ww..wwwww.www
w....w....w.w
wwwwwwwwwwwww
