wwwwwwwwwwwww
w.32..1wA.+3w
w1.2.1...3.3w
w1.3222.2...w
ww33...w.2..w
w23.12.32..2w
wg12222....1w
w1....2..w..w
wwwwwwwwwwwww
