wwwwwwwwwwwww
ww2......1..w
wg.1.....w.ww
w2w.....33w.w
wA.w..1.....w
w.......1..ww
w.1.3.21ww..w
ww..3w.+...3w
wwwwwwwwwwwww
