wwwwwwwwwwwww
w..w..w2.211w
w.w.w.wwwg.1w
ww.+..A.....w
w1w..3www3..w
w.1.w..3.w.3w
w.www.w2ww..w
w.w.2w.w....w
wwwwwwwwwwwww
