wwwwwwwwwwwww
w..2+22...w.w
w.w3w3w1...1w
ww1ww...32w.w
w.w31wgw.1.Aw
w221.121.w2ww
w21.w.133w2.w
ww.33wwww.w1w
wwwwwwwwwwwww
