wwwwwwwwwwwww
w...........w
wg.3..3.1...w
w....A...2..w
w.2.2...1.22w
w..2...1....w
w2+.........w
w...........w
wwwwwwwwwwwww
