wwwwwwwwwwwww
w1w..3.2.3w1w
w3w.+wwww.w.w
wwww.1..w...w
w212.ww.w..Aw
w.3...2w.g.3w
w.ww..www2.ww
www.3w2.3.www
wwwwwwwwwwwww
