wwwwwwwwwwwww
w1..1....w.ww
w1w.2.......w
w....w22..www
w1......+..gw
ww..Aw..ww.3w
w..w........w
w2..3..1....w
wwwwwwwwwwwww
