wwwwwwwwwwwww
w.........+.w
w.w.........w
w.2....w..w.w
w.w...ww.w..w
ww..A..2.w..w
ww..w.g...w.w
w.......ww..w
wwwwwwwwwwwww
