wwwwwwwwwwwww
w2.1w1w122.ww
ww.ww.1..23.w
w.ww.w2.w23.w
w23w.Aw2w2.1w
ww3w11g33..+w
w.22.w13w.w1w
w3w3.w32.w3ww
wwwwwwwwwwwww
