wwwwwwwwwwwww
w+..w2w....ww
ww.w2.w3w.www
ww..1.......w
w......w.gw.w
w3..Awww.wwww
ww....w.....w
w.1.ww.2..2.w
wwwwwwwwwwwww
