wwwwwwwwwwwww
w.ww...3+.w.w
w..w.....3..w
w....13....1w
w2.....1....w
w.2..w21...1w
w2....1...3gw
ww..A.......w
wwwwwwwwwwwww
