wwwwwwwwwwwww
wwww33..w2..w
w2....313wwAw
w....w1w+2w3w
wwg3w..21w31w
ww.w3wwww.w3w
w.....11....w
w..3w.3...w.w
wwwwwwwwwwwww
