wwwwwwwwwwwww
wwww2w..3w..w
w......2ww.Aw
w....1+wg..ww
ww12.....2.ww
w.w..13ww.2ww
w...2.......w
w..ww.w..ww.w
wwwwwwwwwwwww
