wwwwwwwwwwwww
wAw+21.w23.3w
w.312w.22...w
w..31.wwg223w
ww..2..w3.2.w
ww3.332w2w33w
w.w1ww2..w3.w
ww.w11122122w
wwwwwwwwwwwww
