wwwwwwwwwwwww
w3w.gww3.3www
w.222..w.3..w
wwww1..3..32w
w..1+..ww1.Aw
ww...w3222w.w
ww.w23.32.w2w
w.21w..w..23w
wwwwwwwwwwwww
