wwwwwwwwwwwww
w..w.1.3w.w1w
w3g3.w+www1ww
w3A......21ww
w.w3.1.w.2.ww
w.1..w.w3w21w
w...3.2.1w..w
w.212w......w
wwwwwwwwwwwww
