wwwwwwwwwwwww
w232..1....ww
w........2.3w
w......1....w
w2g33...1..3w
w23.1......+w
w.3w3111w.3Aw
w.....1.3...w
wwwwwwwwwwwww
