wwwwwwwwwwwww
w1.w2.133...w
w1ww..1....2w
w.211w31.2.1w
w...A23..gw+w
w.12.3...133w
w..32.2..12.w
w.....2.1..2w
wwwwwwwwwwwww
