wwwwwwwwwwwww
www.+...w..1w
w..ww..1w.Aww
wwwww..w.w.ww
w3......w...w
w.....g...www
w....ww...w.w
ww.www2...w.w
wwwwwwwwwwwww
