wwwwwwwwwwwww
ww..A1.w.333w
ww3ww2w111www
w.1..w11w.w3w
w.2w12ww2..1w
www1.g.ww311w
w.ww.1..23.ww
ww2w1..w+3w3w
wwwwwwwwwwwww
