wwwwwwwwwwwww
w...w.......w
w......+.w..w
w....w...A.ww
ww.....3...ww
w...w....wg.w
w...........w
w....w...w..w
wwwwwwwwwwwww
