wwwwwwwwwwwww
w..31...2.33w
w1...3.1.1..w
w...1..g3w..w
w22..w3....ww
w+..1....3..w
w31.2.......w
w.3..1...3A2w
wwwwwwwwwwwww
