wwwwwwwwwwwww
w1.2..ww2w1.w
w.w..1..2.w.w
w.www11w2...w
w.1g2www1.wAw
w.w.3...2...w
w..3.w+11...w
w...3.....www
wwwwwwwwwwwww
