wwwwwwwwwwwww
w.w..w.w..3.w
ww33.+..2.1.w
wwg...3.2w..w
ww2.3......1w
w...w.2....ww
w1.w313ww2w.w
wA13..3.w1.ww
wwwwwwwwwwwww
