wwwwwwwwwwwww
ww.33.w.w.2ww
w.....w.w2wAw
w.....w.www.w
ww.ww.w.w..1w
w.w..1.g+w2ww
w2w...2w1.3ww
w...ww..ww.ww
wwwwwwwwwwwww
