wwwwwwwwwwwww
w.1..ww+2..2w
w.w2w....2w3w
w.2w.3g.1113w
w.w2.wwww3www
w22.w.www..3w
w...ww..w.A.w
ww.ww.....w.w
wwwwwwwwwwwww
