wwwwwwwwwwwww
wAw22.3.w1..w
w2w..ww223w1w
w3..w.w.w3w.w
wwg.1w.ww213w
w331w...2w32w
w32www.w1.32w
w1w.www122+.w
wwwwwwwwwwwww
