wwwwwwwwwwwww
w.2.11.w21www
w.3+....ww13w
wwww2g.3.w..w
w...w.w2wwwww
www...ww3.www
w3w233w.ww.2w
w.w.wA12w..2w
wwwwwwwwwwwww
