wwwwwwwwwwwww
ww...2w.2w.ww
w...12..2A..w
w1.1.....2w.w
ww.1.1......w
www3..12g.2.w
ww3..33...+ww
w.1w3w.w..31w
wwwwwwwwwwwww
