wwwwwwwwwwwww
w....w......w
w...w....wA.w
ww.......3w.w
ww...1....g.w
w..........ww
w+..1..w.2.3w
w.....311...w
wwwwwwwwwwwww
