wwwwwwwwwwwww
wA..........w
w2.........gw
w....+.3....w
w...........w
w.......2...w
w...........w
w...........w
wwwwwwwwwwwww
