wwwwwwwwwwwww
w.33..+.1.21w
ww1.......2.w
w33.323.21..w
ww.w.2.2.Aw.w
w1...w232.2.w
w.2.1.2.2.1.w
w2..3......gw
wwwwwwwwwwwww
