wwwwwwwwwwwww
w..w...w2w.1w
w.......1.3+w
www..w3...2.w
www...3.1..3w
w.w1w.g.w2w.w
ww.A.22w31.1w
w.....3.w.www
wwwwwwwwwwwww
