wwwwwwwwwwwww
w.2w1w.w.13.w
ww....w.3.31w
w....+..w.w.w
ww..w..w2.www
w...3.33.3..w
w..w....w2.ww
wg1Aw.ww.ww.w
wwwwwwwwwwwww
