wwwwwwwwwwwww
www.33...wwww
ww..w1...A1.w
w1w..w1.w..ww
ww1..g.w+w.ww
w...ww2...www
w.w.ww..w.1.w
ww.ww...wwwww
wwwwwwwwwwwww
