wwwwwwwwwwwww
w11w.......ww
w...w.....w1w
www..+w.....w
w.w.......w.w
w.w1.wwgw..3w
w.wwA.....w.w
w.........3.w
wwwwwwwwwwwww
