wwwwwwwwwwwww
ww..ww2.1.w2w
w...2w.w3A.ww
ww.221....w2w
ww23www.331ww
wwww221w12..w
w1+2.www.3.2w
www3.213g.3ww
wwwwwwwwwwwww
