wwwwwwwwwwwww
w1w.w..www.ww
ww23ww.1w1www
ww.3g..2w..ww
w2w....1ww.ww
w1w.ww1w....w
w.......w.www
w3.2+w.2..A.w
wwwwwwwwwwwww
