wwwwwwwwwwwww
www.w3w3.w.ww
w...w32..2.ww
w..12.......w
wwwg+1ww.13.w
w1A.......w.w
w..1.3..1wwww
w1www1w..1.ww
wwwwwwwwwwwww
