wwwwwwwwwwwww
w...w....w3.w
w.ww.......2w
w.........1.w
ww.....w..A.w
w.w..+.w....w
w...w.......w
w....3.....gw
wwwwwwwwwwwww
