wwwwwwwwwwwww
w..3.....wwww
www...w2w...w
w.w.ww...w..w
wA..+....32.w
w......w...ww
ww.www...wwww
w..w...wg23ww
wwwwwwwwwwwww
