wwwwwwwwwwwww
ww2w3..3w..2w
ww..w.....www
www..w.11.w.w
w..3..1w.wwww
w.12...3.ww3w
w3.....+....w
wwA1...wwwg2w
wwwwwwwwwwwww
