wwwwwwwwwwwww
w..2.....gw.w
w.........2.w
w...2....w..w
w...........w
w3..........w
w.w+........w
w.wA........w
wwwwwwwwwwwww
