wwwwwwwwwwwww
w.2.w..2.23.w
w.2....w3...w
ww3....w...3w
w.......w...w
w.w.+.g.23w.w
w.w.3.A....2w
ww.......ww3w
wwwwwwwwwwwww
