wwwwwwwwwwwww
w..33331.222w
w.2..3.3..3.w
w3...1.A1+22w
w.21.2.23...w
w31..1.22..2w
w1.313......w
w...2g.123..w
wwwwwwwwwwwww
