wwwwwwwwwwwww
w1g...2....2w
www..w..2..ww
w......w.w.2w
w3.2.w.1.w..w
w23w+11..2..w
w.w.w....ww.w
wwA.....w112w
wwwwwwwwwwwww
