wwwwwwwwwwwww
w....A.w....w
w1w..w......w
w....2..w...w
w..w...ww...w
ww3.....w...w
w..w3+.....gw
w.........3.w
wwwwwwwwwwwww
