wwwwwwwwwwwww
w1122.w...g.w
w...32.3+.12w
w.3.31..12.2w
w...121..3..w
w..131..2.11w
wA.....3.122w
w3...1.....3w
wwwwwwwwwwwww
