wwwwwwwwwwwww
w32.ww23.13gw
w.A1ww222w1.w
ww.2w222.ww.w
w.1.w1.3....w
ww3.w..w.11ww
w.+.22.3.2.1w
w.23.w2w....w
wwwwwwwwwwwww
