wwwwwwwwwwwww
w3..w......1w
w.3....Aw..ww
w...w2....g.w
w....ww13.+.w
ww...3...2..w
ww....ww.2.ww
w1.www....w.w
wwwwwwwwwwwww
