wwwwwwwwwwwww
www3+.1.w1.3w
w.ww3..w313.w
w.3w1A.13..ww
w.1ww.233.w.w
w1w11221..22w
ww.w31....22w
w.w3w3w3.11gw
wwwwwwwwwwwww
