wwwwwwwwwwwww
w...........w
w...........w
w....+1.g...w
w2.........2w
w3........2.w
w...........w
w.A.........w
wwwwwwwwwwwww
