wwwwwwwwwwwww
w.2..3w.2...w
w......g2..ww
w.+.....w.w.w
w.2.1....3..w
w.Aww.1.w...w
w...2.1...2.w
ww.32...23.ww
wwwwwwwwwwwww
