wwwwwwwwwwwww
ww...1w1.2www
w...ww+...w.w
w..w.ww.2...w
wwww....www3w
w.3w..w.....w
www...A..g.ww
w...wwww.w.ww
wwwwwwwwwwwww
