wwwwwwwwwwwww
w....1.g..w.w
w....1..w.2ww
ww...13.2...w
w1.2w1...w.2w
w....w+21...w
w...13w.....w
w3...w.1..A.w
wwwwwwwwwwwww
