wwwwwwwwwwwww
w.3w1....w..w
ww.+.w3....3w
w.3wg.wwww..w
w....ww21ww3w
w.1w1www2323w
w1A.1.2ww.22w
ww.132.2.wwww
wwwwwwwwwwwww
