wwwwwwwwwwwww
w211A.1....gw
w..1.1....1.w
w....1.3.21.w
w2..w..11...w
w.3+......2.w
w32w..312333w
w..2...31..2w
wwwwwwwwwwwww
