wwwwwwwwwwwww
w.....1..ww3w
ww....3w.w.ww
w...3wAwwww1w
w..g..w2.w1.w
w+...w3..w..w
w....3..w..3w
w..w..13....w
wwwwwwwwwwwww
