wwwwwwwwwwwww
w..A..+.2...w
w..1..1...3.w
w..1.3......w
w...........w
ww..........w
w..........gw
w...........w
wwwwwwwwwwwww
