wwwwwwwwwwwww
w.2...213232w
w....1......w
w..1.....3.3w
w.....232.1Aw
w....3...13.w
w+22.1...333w
w333.g..1...w
wwwwwwwwwwwww
