wwwwwwwwwwwww
ww...w1..1..w
www3.g1ww...w
w...w...A.w.w
w1+1......1.w
w2.....1.1.1w
ww3.w.1w..2.w
w..w..w.3ww.w
wwwwwwwwwwwww
