wwwwwwwwwwwww
w..w1..1.1.ww
ww1...w...1gw
w.www.....w.w
www..w3w3w.1w
www3...w....w
ww..w.w..w+2w
wwww1Aw..ww3w
wwwwwwwwwwwww
