wwwwwwwwwwwww
w..3313..233w
w..1..1A..13w
w..2.11...w+w
w.w2..1.www.w
w3.ww.www...w
w.3....23..ww
www311..wg.ww
wwwwwwwwwwwww
