wwwwwwwwwwwww
w..w1.3ww.32w
wA2....w.w3ww
ww.2.213313.w
w.1w..g3...1w
w..1...+...ww
w..21.2..311w
ww..22.w....w
wwwwwwwwwwwww
