wwwwwwwwwwwww
w3wwwA..3w32w
w...3+..wwwww
w2.2w.13..www
w2..31.w...3w
w1ww.3ww1.www
w3w.3ww.gw3.w
ww..3121www3w
wwwwwwwwwwwww
