wwwwwwwwwwwww
www.3ww2ww1ww
w.w...3....Aw
w..2w..11.w.w
ww3.w.......w
w..33w....33w
w.1..22+.23.w
w11.3....g.2w
wwwwwwwwwwwww
