wwwwwwwwwwwww
w...22.w....w
w..3..3w+2..w
ww3.........w
w1...g.3.w.Aw
w...ww1....3w
w......w....w
w....w...w2.w
wwwwwwwwwwwww
