wwwwwwwwwwwww
www.33.33w..w
w3..w11..w.2w
w.2w13.1.2w.w
ww3A22+2.22ww
w1.g.....3..w
w3113..331..w
w.w3w.3.w.w3w
wwwwwwwwwwwww
