wwwwwwwwwwwww
ww.w.......ww
w..w.www..w.w
w.w...+.....w
w....w.g....w
w....w.ww...w
w....A....w.w
w...ww....w.w
wwwwwwwwwwwww
