wwwwwwwwwwwww
w2......3.g.w
w.2.1..33...w
ww3..ww1...1w
w.3..w2+3...w
w2.3...1....w
wA.1.3..w2.ww
w2.1133.....w
wwwwwwwwwwwww
