wwwwwwwwwwwww
w...w...g...w
w.1..w2ww...w
w..1ww2A.w.ww
w.....+1.3..w
w...w.w.w.1ww
w11.w33..1..w
w.w3...w3.31w
wwwwwwwwwwwww
