wwwwwwwwwwwww
w1.......w31w
w.w.w..w....w
ww.w..ww..w.w
w....3...+w.w
w..wg....wwww
ww.ww.......w
wA.w.3...w..w
wwwwwwwwwwwww
