wwwwwwwwwwwww
w3w...w..gw2w
w...w...w..3w
w.ww..w.12.ww
ww.w.w..w.2ww
w.ww2..ww..ww
w.w..w..ww33w
wA+.w2.w3...w
wwwwwwwwwwwww
