wwwwwwwwwwwww
w3.w3.wg2332w
w313ww11.3w3w
ww...w3.w.www
ww..22www...w
w.1w3wwwww11w
wwAw23.3..w1w
w3w.1+223..3w
wwwwwwwwwwwww
