wwwwwwwwwwwww
w.w.www..w3.w
w3+w1.1..w1.w
wgww...A1...w
w2.ww...1.w.w
w2w..w.w.2.1w
w.w23..w...ww
w..1....w13.w
wwwwwwwwwwwww
