wwwwwwwwwwwww
wwwwwwwww.www
w..w.....1w3w
w...33w..w.ww
wwwww...32www
www1...w.ww.w
w...wwwA.+www
w..www2.wg3ww
wwwwwwwwwwwww
