wwwwwwwwwwwww
ww3.w.www.gww
ww..www.ww1ww
wwww.w.ww..ww
w.....3..w.+w
w.w.w..1.A.ww
w..wwww.w.33w
w..ww.w..w1.w
wwwwwwwwwwwww
