wwwwwwwwwwwww
ww1ww.ww..3.w
w.+w.....ww.w
w....w..w.w.w
w2...gw.ww..w
w.w.3.w...www
w.A......w.ww
wwww2.w...w.w
wwwwwwwwwwwww
