wwwwwwwwwwwww
w.w2..w.....w
wwwwww3.w..2w
w....ww.w...w
w.gw3...w..ww
ww2.1w..ww2.w
w...w...w.w.w
w..+w.....A.w
wwwwwwwwwwwww
