wwwwwwwwwwwww
w.w..3w...w.w
ww..A..www..w
w...w...22www
w.w.1...2..gw
ww.....w...ww
w....ww...www
w.....+ww.www
wwwwwwwwwwwww
