wwwwwwwwwwwww
w..w.w...3w1w
ww..1.w.w.w3w
w...w1w....ww
w.www.w...w.w
www.ww3www..w
ww.A3..+ww2ww
ww1wwgw..ww.w
wwwwwwwwwwwww
