wwwwwwwwwwwww
w...ww.w...ww
w.1w...www..w
w...w1.w.w..w
wg..2.w.ww..w
w.ww..A1.ww.w
w..+wwwww.2.w
w...2ww....ww
wwwwwwwwwwwww
