wwwwwwwwwwwww
ww1..2w+w323w
w.....32w...w
w3w.ww.w.ww.w
w13.w.www1w3w
w.1.3.3...2ww
w....2w3w.w.w
wwA.3g21.22.w
wwwwwwwwwwwww
