wwwwwwwwwwwww
ww.w.w11.1w3w
w.w....ww2.3w
www2wwA.w...w
w3w..1..w2..w
w.2....+..w1w
ww.w..g2..www
w.ww.ww.w.www
wwwwwwwwwwwww
