wwwwwwwwwwwww
w.ww.2g.w.31w
www.2w21.2www
w23w..w.3w.ww
w..1.w..w.2.w
w.ww2.w2..www
w.ww.1wwAww.w
www.+...www.w
wwwwwwwwwwwww
