wwwwwwwwwwwww
w.w.w..3..w.w
ww.w..w...www
ww.ww+2.Aw..w
www....w...ww
w2w.w111.w.ww
w.3...w.ww..w
w.3g....w.1.w
wwwwwwwwwwwww
