wwwwwwwwwwwww
ww1www.w2.1ww
wwg+wwww.ww1w
ww.Aww22w3w2w
www1.w..ww.ww
www.w2ww.w2ww
ww...www1ww3w
wwwwwwww..www
wwwwwwwwwwwww
