wwwwwwwwwwwww
w.3..1.2...+w
w.3ww.wwww2gw
w.ww......1.w
w.1..2.www1ww
w.w..13ww.w3w
ww.w1w.3..w.w
w..32.....A.w
wwwwwwwwwwwww
