wwwwwwwwwwwww
w.www...221.w
ww.ww.A.wwwww
w.wwww.2.w3.w
w2w..w..www.w
w.w....w2.+3w
ww1ww..w.2.3w
w2w.g..1.ww.w
wwwwwwwwwwwww
