wwwwwwwwwwwww
w..2....w..ww
w..w.w2....3w
w...g....w..w
w.2ww..1www.w
ww.w.w....w.w
w..21..A1..ww
w.w3..+.....w
wwwwwwwwwwwww
