wwwwwwwwwwwww
w....w3....3w
ww....w+.wwww
w.w....w...ww
w.3.w2wwAw..w
w.ww.w1..wgww
www3..w.www.w
w.11.....w..w
wwwwwwwwwwwww
