wwwwwwwwwwwww
ww1+2.w.1.w.w
w.2.ww....1.w
w1.3ww.w.w1ww
w1......w2.Aw
ww1..ww..w.ww
w3w.ww..ww33w
w..g..32.2.ww
wwwwwwwwwwwww
