wwwwwwwwwwwww
ww..wA3...w.w
w.......w..ww
www...ww3.www
ww....w.w+w.w
w..w.www....w
w..ww.wwwg..w
www3.1www1..w
wwwwwwwwwwwww
