wwwwwwwwwwwww
ww..31.w....w
w2ww..w.ww..w
w.g..ww..w..w
wwww..w.w..ww
w.+..w.2ww..w
ww..A.ww..w.w
w.3..w.w...ww
wwwwwwwwwwwww
