wwwwwwwwwwwww
w...ww...w.ww
w.gw..w.+..ww
ww.......w.ww
ww.ww..wwww.w
ww.w.....w..w
ww.w.w..ww.ww
w..A........w
wwwwwwwwwwwww
