wwwwwwwwwwwww
w....wwwwww1w
w.1ww..331..w
ww...w2w.ww.w
wg1....w23w2w
w3.ww.3.ww12w
w2ww1.31.w3.w
ww..w2ww.A+.w
wwwwwwwwwwwww
