wwwwwwwwwwwww
ww.w122...w3w
w13....3.33.w
wgw13Aw....ww
w222.....w21w
w32.3w11..w+w
wwww3..w..2ww
ww3w.w3w..3.w
wwwwwwwwwwwww
