wwwwwwwwwwwww
w.2w3g33.133w
w2313www.3+ww
w2ww.ww....ww
ww12.wwwww..w
ww1.3wwwwww.w
ww.ww.3w..w3w
w3Aw1..11w2ww
wwwwwwwwwwwww
