wwwwwwwwwwwww
w.2wgw1..3..w
w.w....2w..ww
w.ww.wwww.3.w
www.w..2w...w
w...w..w...ww
w.wwww.w.A3ww
w..+1.....w.w
wwwwwwwwwwwww
