wwwwwwwwwwwww
w.ww.wwww1.2w
wgw.w3.w..www
w.w2..23.w3.w
w.+.w2ww....w
w.w..w.Awww.w
w.1w...w...1w
w.3.w31w.ww3w
wwwwwwwwwwwww
