wwwwwwwwwwwww
w..+.w2g1w.1w
w2w3w1w1.A21w
w1w.....w...w
w.w3.w223w3ww
w2w111w.ww.2w
w.ww...www..w
w2...w13w.2.w
wwwwwwwwwwwww
