wwwwwwwwwwwww
wwwww.+..w3ww
ww3.w..wA1.gw
w.w.....1..ww
ww.3.w..w.www
ww..w.1.....w
w312ww.1...ww
ww.3.ww..w3.w
wwwwwwwwwwwww
