wwwwwwwwwwwww
w.w..w.w....w
www.+ww1ww.ww
w...ww.w....w
ww.w....w.w.w
ww....w...w2w
ww..w.2..wwgw
w.w2wwA.....w
wwwwwwwwwwwww
