wwwwwwwwwwwww
w.w...ww..w.w
wgwww.wAwwwww
w1w.1.w3w..ww
w......+..www
ww.ww.ww..w.w
w...w.w....ww
wwww.ww..ww.w
wwwwwwwwwwwww
