wwwwwwwwwwwww
w.3www.w..www
w..w.w211A.ww
www.2..3www.w
w1.ww3www..ww
w.+ww.....www
w.w2.w112w3.w
w..1g22.w1..w
wwwwwwwwwwwww
