wwwwwwwwwwwww
w.1.w1.w.w.Aw
ww.w1.w.w.3ww
w.w.w.w.ww.ww
w...w...1..3w
wg...w+2ww.ww
ww.w..2ww..ww
w..w...w..31w
wwwwwwwwwwwww
