wwwwwwwwwwwww
w...ww.w....w
w...........w
wwwA+w.w.w..w
w...w...1w..w
w....w......w
w..g.w.3w...w
w.32w.www.w.w
wwwwwwwwwwwww
