wwwwwwwwwwwww
ww.w...w..w.w
w.1wwwww+w.ww
wwwwwg.....ww
ww....ww..www
w....w.ww..Aw
w.w.ww.w.ww.w
ww..w...w.www
wwwwwwwwwwwww
