wwwwwwwwwwwww
w.w.ww2wAwwww
ww.w..ww.gwww
w...ww.1w...w
ww...www..+ww
www.1www...2w
ww32..w..w.1w
w22w..1.1..ww
wwwwwwwwwwwww
