wwwwwwwwwwwww
ww..w.ww....w
w...w.wA2w1.w
w3w..2w.w.w.w
w3w1....ww.+w
ww..1.gw...2w
w..w.www...2w
www2w....3..w
wwwwwwwwwwwww
