wwwwwwwwwwwww
w.ww.g...3.3w
w...ww1ww1w.w
w.1w.....+w.w
w...w.w...www
w.ww..3ww.www
www.ww.Aw..ww
w..1..ww.w..w
wwwwwwwwwwwww
