wwwwwwwwwwwww
w.w.11....3.w
w..+A...3w.ww
ww1w.1w.....w
w..www.....ww
wwww.w2w.ww2w
www2..1ww..ww
www.wwgw.w3.w
wwwwwwwwwwwww
