wwwwwwwwwwwww
w2...1+.ww.ww
w..Aw..2....w
w3w.....wwwww
w...w.w.2.www
wwww.....wwww
w1ww.w.w.w3.w
w..w.w..g.w.w
wwwwwwwwwwwww
