wwwwwwwwwwwww
w22w.2w133www
w1A22..w..w.w
ww.ww..w.2w1w
w.ww..www..ww
w.1+...ww2w.w
w12.w2ww31..w
w.g3ww..2w..w
wwwwwwwwwwwww
