wwwwwwwwwwwww
w21www3w1w.ww
ww2w.1www33.w
w...3ww1+w23w
www3.A1.w..ww
wwg.2..1.w1ww
ww2w.www.22.w
www..wwww.w3w
wwwwwwwwwwwww
