wwwwwwwwwwwww
w..w.w.w.w.ww
w..g3w31..www
w33...www...w
w..w.ww.w.w.w
w+ww..ww....w
wAw.w..w.ww.w
ww.w3ww...www
wwwwwwwwwwwww
