wwwwwwwwwwwww
ww.1.2w...w.w
w..3..ww1.w2w
w.22w..ww...w
ww...wg+.1..w
w.w...w..2..w
w32.3.2.....w
w.......wAw.w
wwwwwwwwwwwww
