wwwwwwwwwwwww
w..2..32..1.w
w2....2.Ag3.w
w..2.....2..w
w1..........w
w+..1.......w
w2...2.1.1..w
w1...1......w
wwwwwwwwwwwww
