wwwwwwwwwwwww
w.....2..w3.w
w.wA1w2+.w2.w
w1.w.w2.212.w
w...1.w11.w1w
w211w31.12.3w
w2..w..g..w.w
w2w3.3w.23w1w
wwwwwwwwwwwww
