wwwwwwwwwwwww
ww.w.w2w...3w
w..3w.2w+23.w
w2132..313.Aw
w...2ww31.1.w
ww.3.1w..1..w
w.2w.w..g3.ww
w2.22w3....2w
wwwwwwwwwwwww
